observation_name	taxonomic_affiliation
Cluster_1	cellular organisms;Bacteria;Spirochaetota;Spirochaetia;Spirochaetales;Spirochaetaceae;Sphaerochaeta;unknown species
Cluster_2	cellular organisms;Bacteria;Cloacimonadota;Cloacimonadia;Cloacimonadales;Cloacimonadaceae;W5;unknown species
Cluster_3	cellular organisms;Bacteria;Cloacimonadota;Cloacimonadia;Cloacimonadales;Cloacimonadaceae;Candidatus Cloacimonas;unknown species
Cluster_4	cellular organisms;Bacteria;Bacteroidota;Bacteroidia;Bacteroidales;Rikenellaceae;Rikenellaceae RC9 gut group;unknown species
Cluster_5	cellular organisms;Bacteria;Cloacimonadota;Cloacimonadia;Cloacimonadales;Cloacimonadaceae;W5;unknown species
Cluster_6	cellular organisms;Bacteria;Firmicutes;Clostridia;Clostridiales;Clostridiaceae;Clostridium sensu stricto 1;unknown species
Cluster_7	cellular organisms;Bacteria;Chloroflexi;Anaerolineae;Anaerolineales;Anaerolineaceae;ADurb.Bin120;Brevefilum fermentans
Cluster_9	cellular organisms;Bacteria;Spirochaetota;Spirochaetia;Spirochaetales;Spirochaetaceae;Sphaerochaeta;unknown species
Cluster_10	cellular organisms;Bacteria;Bacteroidota;Bacteroidia;Bacteroidales;Dysgonomonadaceae;Fermentimonas;Fermentimonas caenicola
Cluster_11	cellular organisms;Bacteria;Bacteroidota;Bacteroidia;Sphingobacteriales;ST-12K33;unknown genus;metagenome
Cluster_12	cellular organisms;Bacteria;Bacteroidota;Bacteroidia;Bacteroidales;Rikenellaceae;Multi-affiliation;Multi-affiliation
Cluster_13	cellular organisms;Bacteria;Bacteroidota;Bacteroidia;Bacteroidales;Dysgonomonadaceae;Proteiniphilum;Multi-affiliation
Cluster_15	cellular organisms;Bacteria;Firmicutes;Syntrophomonadia;Syntrophomonadales;Syntrophomonadaceae;Syntrophomonas;unknown species
Cluster_16	cellular organisms;Bacteria;Bacteroidota;Bacteroidia;Bacteroidales;Rikenellaceae;DMER64;Rikenellaceae bacterium DTU002
Cluster_17	cellular organisms;Bacteria;Bacteroidota;Bacteroidia;Bacteroidales;Dysgonomonadaceae;Proteiniphilum;unknown species
Cluster_18	cellular organisms;Bacteria;Bacteroidota;Bacteroidia;Bacteroidales;Prolixibacteraceae;unknown genus;unknown species
Cluster_19	cellular organisms;Bacteria;Bacteroidota;Bacteroidia;Bacteroidales;Bacteroidales UCG-001;unknown genus;unknown species
Cluster_20	cellular organisms;Bacteria;Firmicutes;Clostridia;Peptostreptococcales-Tissierellales;Peptostreptococcaceae;Multi-affiliation;Multi-affiliation
Cluster_21	cellular organisms;Bacteria;Bacteroidota;Bacteroidia;Bacteroidales;Dysgonomonadaceae;Fermentimonas;unknown species
Cluster_22	cellular organisms;Bacteria;Firmicutes;Bacilli;Erysipelotrichales;Erysipelotrichaceae;Turicibacter;Multi-affiliation
Cluster_23	cellular organisms;Archaea;Euryarchaeota;Methanobacteria;Methanobacteriales;Methanobacteriaceae;Methanobacterium;unknown species
Cluster_24	cellular organisms;Archaea;Halobacterota;Methanosarcinia;Methanosarciniales;Methanosaetaceae;Methanosaeta;Multi-affiliation
Cluster_25	cellular organisms;Bacteria;Firmicutes;Bacilli;Erysipelotrichales;Erysipelatoclostridiaceae;UCG-004;unknown species
Cluster_26	cellular organisms;Bacteria;Actinobacteriota;Actinobacteria;Propionibacteriales;Propionibacteriaceae;Propioniciclava;Multi-affiliation
Cluster_27	cellular organisms;Bacteria;Firmicutes;Desulfotomaculia;Desulfotomaculales;Pelotomaculaceae;Pelotomaculum;unknown species
Cluster_28	cellular organisms;Bacteria;Bacteroidota;Bacteroidia;Bacteroidales;Rikenellaceae;unknown genus;unknown species
Cluster_29	cellular organisms;Bacteria;Firmicutes;unknown class;DTU014;unknown family;unknown genus;unknown species
Cluster_30	cellular organisms;Bacteria;Firmicutes;Limnochordia;MBA03;unknown family;unknown genus;unknown species
Cluster_31	cellular organisms;Bacteria;Firmicutes;Bacilli;Lactobacillales;Lactobacillaceae;Amylolactobacillus;unknown species
Cluster_32	cellular organisms;Bacteria;Firmicutes;Bacilli;Lactobacillales;Streptococcaceae;Lactococcus;Multi-affiliation
Cluster_33	cellular organisms;Bacteria;Firmicutes;Bacilli;Lactobacillales;Lactobacillaceae;Latilactobacillus;Lactobacillus fuchuensis
Cluster_34	cellular organisms;Bacteria;Bacteroidota;Bacteroidia;Bacteroidales;Bacteroidetes vadinHA17;unknown genus;unknown species
Cluster_35	cellular organisms;Bacteria;Verrucomicrobiota;Verrucomicrobiae;LD1-PB3;unknown family;unknown genus;unknown species
Cluster_36	cellular organisms;Bacteria;Spirochaetota;Spirochaetia;Spirochaetales;Spirochaetaceae;Sphaerochaeta;unknown species
Cluster_37	cellular organisms;Bacteria;Firmicutes;Clostridia;Peptostreptococcales-Tissierellales;Peptostreptococcaceae;Terrisporobacter;unknown species
Cluster_38	cellular organisms;Bacteria;Proteobacteria;Gammaproteobacteria;Pseudomonadales;Pseudomonadaceae;Pseudomonas;Pseudomonas sp.
Cluster_39	cellular organisms;Bacteria;Actinobacteriota;Actinobacteria;Propionibacteriales;Propionibacteriaceae;Propionimicrobium;unknown species
Cluster_40	cellular organisms;Bacteria;Firmicutes;Bacilli;Lactobacillales;Lactobacillaceae;Paucilactobacillus;Multi-affiliation
Cluster_41	cellular organisms;Bacteria;Bacteroidota;Bacteroidia;Bacteroidales;Dysgonomonadaceae;unknown genus;unknown species
Cluster_42	cellular organisms;Bacteria;Firmicutes;Clostridia;Caldicoprobacterales;Caldicoprobacteraceae;Caldicoprobacter;Multi-affiliation
Cluster_43	cellular organisms;Bacteria;Bacteroidota;Bacteroidia;Bacteroidales;Rikenellaceae;unknown genus;unknown species
Cluster_44	cellular organisms;Bacteria;Firmicutes;Clostridia;Lachnospirales;Lachnospiraceae;unknown genus;unknown species
Cluster_45	cellular organisms;Bacteria;Firmicutes;Clostridia;Oscillospirales;Hungateiclostridiaceae;HN-HF0106;unknown species
Cluster_46	cellular organisms;Bacteria;Firmicutes;Limnochordia;MBA03;unknown family;unknown genus;Multi-affiliation
Cluster_47	cellular organisms;Bacteria;Firmicutes;Bacilli;Lactobacillales;Enterococcaceae;Enterococcus;Enterococcus aquimarinus
Cluster_48	cellular organisms;Bacteria;Firmicutes;unknown class;DTU014;unknown family;unknown genus;Multi-affiliation
Cluster_49	cellular organisms;Bacteria;Firmicutes;Bacilli;Lactobacillales;Enterococcaceae;Enterococcus;unknown species
Cluster_51	cellular organisms;Bacteria;Firmicutes;Clostridia;Oscillospirales;Hungateiclostridiaceae;Ruminiclostridium;unknown species
Cluster_53	cellular organisms;Bacteria;Spirochaetota;Spirochaetia;Spirochaetales;Spirochaetaceae;Sphaerochaeta;unknown species
Cluster_54	cellular organisms;Bacteria;Firmicutes;Bacilli;Lactobacillales;Carnobacteriaceae;Trichococcus;Multi-affiliation
Cluster_55	cellular organisms;Bacteria;Bacteroidota;Bacteroidia;Bacteroidales;Dysgonomonadaceae;Fermentimonas;unknown species
Cluster_56	cellular organisms;Bacteria;Firmicutes;Clostridia;Peptostreptococcales-Tissierellales;Anaerovoracaceae;unknown genus;anaerobic digester metagenome
Cluster_57	cellular organisms;Archaea;Halobacterota;Methanosarcinia;Methanosarciniales;Methanosarcinaceae;Methanosarcina;Multi-affiliation
Cluster_60	cellular organisms;Bacteria;Firmicutes;Clostridia;Oscillospirales;Hungateiclostridiaceae;Acetivibrio;Multi-affiliation
Cluster_61	cellular organisms;Bacteria;Firmicutes;Bacilli;Desulfuribacillales;Desulfuribacillaceae;Desulfuribacillus;unknown species
Cluster_62	cellular organisms;Bacteria;Firmicutes;Clostridia;Peptostreptococcales-Tissierellales;Anaerovoracaceae;Anaerovorax;unknown species
Cluster_63	cellular organisms;Bacteria;Bacteroidota;Bacteroidia;Bacteroidales;Rikenellaceae;Rikenellaceae RC9 gut group;unknown species
Cluster_64	cellular organisms;Bacteria;Bacteroidota;Bacteroidia;Bacteroidales;Rikenellaceae;Rikenellaceae RC9 gut group;unknown species
Cluster_65	cellular organisms;Bacteria;Bacteroidota;Bacteroidia;Bacteroidales;MgMjR-022;unknown genus;unknown species
Cluster_66	cellular organisms;Bacteria;Firmicutes;Clostridia;Clostridiales;Clostridiaceae;Clostridium sensu stricto 1;Multi-affiliation
Cluster_67	cellular organisms;Bacteria;Firmicutes;Bacilli;Erysipelotrichales;Erysipelatoclostridiaceae;UCG-004;unknown species
Cluster_68	cellular organisms;Bacteria;Firmicutes;Clostridia;Oscillospirales;Hungateiclostridiaceae;Fastidiosipila;unknown species
Cluster_70	cellular organisms;Bacteria;Cloacimonadota;Cloacimonadia;Cloacimonadales;W27;unknown genus;unknown species
Cluster_71	cellular organisms;Bacteria;Bacteroidota;Bacteroidia;Bacteroidales;Paludibacteraceae;unknown genus;metagenome
Cluster_72	cellular organisms;Bacteria;Firmicutes;Clostridia;Clostridiales;Clostridiaceae;Clostridium sensu stricto 1;unknown species
Cluster_73	cellular organisms;Bacteria;Firmicutes;Bacilli;Lactobacillales;Lactobacillaceae;Lapidilactobacillus;Multi-affiliation
Cluster_74	cellular organisms;Bacteria;Bacteroidota;Bacteroidia;Sphingobacteriales;Lentimicrobiaceae;Lentimicrobium;Multi-affiliation
Cluster_75	cellular organisms;Bacteria;Firmicutes;Syntrophomonadia;Syntrophomonadales;Syntrophomonadaceae;unknown genus;unknown species
Cluster_76	cellular organisms;Bacteria;Firmicutes;unknown class;DTU014;unknown family;unknown genus;unknown species
Cluster_77	cellular organisms;Bacteria;Bacteroidota;Bacteroidia;Bacteroidales;Paludibacteraceae;unknown genus;unknown species
Cluster_78	cellular organisms;Bacteria;Firmicutes;Clostridia;Oscillospirales;Hungateiclostridiaceae;HN-HF0106;unknown species
Cluster_79	cellular organisms;Bacteria;Synergistota;Synergistia;Synergistales;Synergistaceae;unknown genus;unknown species
Cluster_81	cellular organisms;Bacteria;Firmicutes;Clostridia;Lachnospirales;Lachnospiraceae;Herbinix;unknown species
Cluster_82	cellular organisms;Bacteria;Firmicutes;Clostridia;Oscillospirales;unknown family;unknown genus;unknown species
Cluster_83	cellular organisms;Bacteria;Cloacimonadota;Cloacimonadia;Cloacimonadales;W27;unknown genus;unknown species
Cluster_84	cellular organisms;Bacteria;Firmicutes;Bacilli;Lactobacillales;Lactobacillaceae;Latilactobacillus;Multi-affiliation
Cluster_85	cellular organisms;Bacteria;Caldatribacteriota;Caldatribacteriia;Caldatribacteriales;Caldatribacteriaceae;Candidatus Caldatribacterium;unknown species
Cluster_86	cellular organisms;Bacteria;Actinobacteriota;Actinobacteria;Propionibacteriales;Propionibacteriaceae;Brooklawnia;Brooklawnia cerclae
Cluster_87	cellular organisms;Bacteria;Firmicutes;Bacilli;Lactobacillales;Enterococcaceae;Enterococcus;unknown species
Cluster_88	cellular organisms;Bacteria;Firmicutes;Clostridia;Oscillospirales;Hungateiclostridiaceae;HN-HF0106;metagenome
Cluster_89	cellular organisms;Bacteria;Bacteroidota;Bacteroidia;Bacteroidales;Dysgonomonadaceae;Fermentimonas;unknown species
Cluster_90	cellular organisms;Bacteria;Bacteroidota;Bacteroidia;Bacteroidales;Prolixibacteraceae;Mariniphaga;unknown species
Cluster_91	cellular organisms;Bacteria;Bacteroidota;Bacteroidia;Bacteroidales;Williamwhitmaniaceae;Blvii28 wastewater-sludge group;unknown species
Cluster_92	cellular organisms;Bacteria;Firmicutes;Bacilli;Lactobacillales;Lactobacillaceae;Leuconostoc;Leuconostoc carnosum
Cluster_93	cellular organisms;Bacteria;Bacteroidota;Bacteroidia;Bacteroidales;Marinilabiliaceae;unknown genus;unknown species
Cluster_94	cellular organisms;Bacteria;Firmicutes;Clostridia;Christensenellales;Christensenellaceae;Christensenellaceae R-7 group;unknown species
Cluster_95	cellular organisms;Bacteria;Bacteroidota;Bacteroidia;Bacteroidales;M2PB4-65 termite group;unknown genus;unknown species
Cluster_96	cellular organisms;Bacteria;Bdellovibrionota;Oligoflexia;053A03-B-DI-P58;unknown family;unknown genus;unknown species
Cluster_97	cellular organisms;Bacteria;Synergistota;Synergistia;Synergistales;Synergistaceae;unknown genus;Multi-affiliation
Cluster_98	cellular organisms;Bacteria;Firmicutes;Clostridia;Peptostreptococcales-Tissierellales;Anaerovoracaceae;Anaerovorax;unknown species
Cluster_99	cellular organisms;Bacteria;Firmicutes;Syntrophomonadia;Syntrophomonadales;Syntrophomonadaceae;Syntrophomonas;Syntrophomonas wolfei
Cluster_100	cellular organisms;Bacteria;WPS-2;unknown class;unknown order;unknown family;unknown genus;Burkholderiales bacterium Beta_02
Cluster_101	cellular organisms;Archaea;Halobacterota;Methanosarcinia;Methanosarciniales;Methanosarcinaceae;Methanomethylovorans;unknown species
Cluster_102	cellular organisms;Bacteria;Synergistota;Synergistia;Synergistales;Synergistaceae;unknown genus;Multi-affiliation
Cluster_103	cellular organisms;Bacteria;Firmicutes;Clostridia;Clostridiales;Clostridiaceae;Multi-affiliation;Multi-affiliation
Cluster_104	cellular organisms;Bacteria;Bacteroidota;Bacteroidia;Bacteroidales;Paludibacteraceae;unknown genus;Multi-affiliation
Cluster_105	cellular organisms;Bacteria;Firmicutes;Bacilli;Lactobacillales;Lactobacillaceae;Loigolactobacillus;Lactobacillus coryniformis
Cluster_106	cellular organisms;Bacteria;Bacteroidota;Bacteroidia;Bacteroidales;Bacteroidaceae;Bacteroides;Multi-affiliation
Cluster_107	cellular organisms;Bacteria;Firmicutes;Clostridia;Caldicoprobacterales;Caldicoprobacteraceae;Caldicoprobacter;Multi-affiliation
Cluster_109	cellular organisms;Bacteria;Bacteroidota;Bacteroidia;Bacteroidales;Marinilabiliaceae;Ruminofilibacter;Multi-affiliation
Cluster_110	cellular organisms;Bacteria;Firmicutes;Clostridia;Peptostreptococcales-Tissierellales;Family XI;W5053;unknown species
Cluster_111	cellular organisms;Bacteria;Firmicutes;Clostridia;Peptostreptococcales-Tissierellales;Family XI;W5053;unknown species
Cluster_112	cellular organisms;Bacteria;Firmicutes;Clostridia;Peptostreptococcales-Tissierellales;Sedimentibacteraceae;Sedimentibacter;unknown species
Cluster_114	cellular organisms;Bacteria;Firmicutes;Clostridia;Peptococcales;Peptococcaceae;unknown genus;unknown species
Cluster_115	cellular organisms;Bacteria;Bacteroidota;Bacteroidia;Bacteroidales;Dysgonomonadaceae;Proteiniphilum;unknown species
Cluster_116	cellular organisms;Bacteria;Spirochaetota;Spirochaetia;Spirochaetales;Spirochaetaceae;Treponema;unknown species
Cluster_117	cellular organisms;Bacteria;Chloroflexi;Anaerolineae;Anaerolineales;Anaerolineaceae;unknown genus;unknown species
Cluster_118	cellular organisms;Bacteria;Spirochaetota;Spirochaetia;Spirochaetales;Spirochaetaceae;Sphaerochaeta;unknown species
Cluster_119	cellular organisms;Bacteria;Firmicutes;Clostridia;Peptostreptococcales-Tissierellales;Family XI;Gallicola;Peptostreptococcaceae bacterium SK031
Cluster_120	cellular organisms;Bacteria;Firmicutes;Clostridia;Peptostreptococcales-Tissierellales;Sedimentibacteraceae;Sedimentibacter;unknown species
Cluster_121	cellular organisms;Bacteria;Firmicutes;Syntrophomonadia;Syntrophomonadales;Syntrophomonadaceae;Syntrophomonas;unknown species
Cluster_122	cellular organisms;Bacteria;Bacteroidota;Bacteroidia;Sphingobacteriales;ST-12K33;unknown genus;metagenome
Cluster_123	cellular organisms;Archaea;Crenarchaeota;Bathyarchaeia;unknown order;unknown family;unknown genus;Multi-affiliation
Cluster_125	cellular organisms;Bacteria;Caldatribacteriota;JS1;unknown order;unknown family;unknown genus;unknown species
Cluster_126	cellular organisms;Bacteria;Proteobacteria;Gammaproteobacteria;Burkholderiales;Alcaligenaceae;Alcaligenes;Multi-affiliation
Cluster_127	cellular organisms;Bacteria;Firmicutes;Limnochordia;MBA03;unknown family;unknown genus;unknown species
Cluster_128	cellular organisms;Bacteria;Firmicutes;Bacilli;Lactobacillales;Vagococcaceae;Vagococcus;Vagococcus acidifermentans
Cluster_129	cellular organisms;Bacteria;Firmicutes;Clostridia;Peptococcales;Peptococcaceae;unknown genus;unknown species
Cluster_130	cellular organisms;Bacteria;Firmicutes;Clostridia;Christensenellales;Christensenellaceae;Christensenellaceae R-7 group;unknown species
Cluster_131	cellular organisms;Bacteria;Firmicutes;Clostridia;Peptostreptococcales-Tissierellales;Family XI;W5053;unknown species
Cluster_132	cellular organisms;Bacteria;Firmicutes;Clostridia;Lachnospirales;Lachnospiraceae;Herbinix;unknown species
Cluster_133	cellular organisms;Archaea;Halobacterota;Multi-affiliation;Multi-affiliation;Multi-affiliation;Multi-affiliation;Multi-affiliation
Cluster_134	cellular organisms;Bacteria;Firmicutes;Clostridia;Clostridia UCG-014;unknown family;unknown genus;unknown species
Cluster_136	cellular organisms;Bacteria;Synergistota;Synergistia;Synergistales;Synergistaceae;unknown genus;unknown species
Cluster_138	cellular organisms;Bacteria;Firmicutes;Clostridia;Peptostreptococcales-Tissierellales;Sedimentibacteraceae;Sedimentibacter;unknown species
Cluster_139	cellular organisms;Bacteria;Bacteroidota;Bacteroidia;Bacteroidales;Dysgonomonadaceae;Fermentimonas;unknown species
Cluster_140	cellular organisms;Bacteria;Bacteroidota;Bacteroidia;Bacteroidales;Rikenellaceae;DMER64;unknown species
Cluster_141	cellular organisms;Bacteria;Firmicutes;Clostridia;Clostridiales;Clostridiaceae;Clostridium sensu stricto 8;Multi-affiliation
Cluster_142	cellular organisms;Bacteria;Fibrobacterota;Fibrobacteria;Fibrobacterales;Fibrobacteraceae;Fibrobacter;unknown species
Cluster_143	cellular organisms;Bacteria;Firmicutes;Bacilli;Lactobacillales;Carnobacteriaceae;Jeotgalibaca;unknown species
Cluster_144	cellular organisms;Archaea;Halobacterota;Methanomicrobia;Methanomicrobiales;Methanocorpusculaceae;Methanocorpusculum;Multi-affiliation
Cluster_145	cellular organisms;Bacteria;Firmicutes;Clostridia;Clostridiales;Clostridiaceae;Proteiniclasticum;unknown species
Cluster_146	cellular organisms;Bacteria;Firmicutes;Clostridia;Caldicoprobacterales;Caldicoprobacteraceae;Caldicoprobacter;unknown species
Cluster_148	cellular organisms;Bacteria;Bacteroidota;Bacteroidia;Bacteroidales;FTLpost3;unknown genus;unknown species
Cluster_149	cellular organisms;Bacteria;Firmicutes;Clostridia;Caldicoprobacterales;Caldicoprobacteraceae;Caldicoprobacter;Multi-affiliation
Cluster_151	cellular organisms;Bacteria;Bacteroidota;Bacteroidia;Bacteroidales;Dysgonomonadaceae;Petrimonas;Petrimonas mucosa
Cluster_150	cellular organisms;Bacteria;Synergistota;Synergistia;Synergistales;Synergistaceae;unknown genus;unknown species
Cluster_152	cellular organisms;Bacteria;Firmicutes;Clostridia;Peptostreptococcales-Tissierellales;unknown family;Guggenheimella;Guggenheimella bovis
Cluster_153	cellular organisms;Bacteria;Spirochaetota;Spirochaetia;Spirochaetales;Spirochaetaceae;Sphaerochaeta;unknown species
Cluster_154	cellular organisms;Bacteria;Actinobacteriota;Actinobacteria;Propionibacteriales;Propionibacteriaceae;Propionimicrobium;unknown species
Cluster_155	cellular organisms;Bacteria;Firmicutes;Clostridia;Peptostreptococcales-Tissierellales;Peptostreptococcaceae;Terrisporobacter;unknown species
Cluster_156	cellular organisms;Bacteria;Bacteroidota;Bacteroidia;Bacteroidales;GZKB124;unknown genus;unknown species
Cluster_157	cellular organisms;Bacteria;Bacteroidota;Bacteroidia;Bacteroidales;Rikenellaceae;Rikenellaceae RC9 gut group;unknown species
Cluster_158	cellular organisms;Bacteria;Bacteroidota;Bacteroidia;Bacteroidales;Dysgonomonadaceae;Proteiniphilum;unknown species
Cluster_159	cellular organisms;Bacteria;Firmicutes;Bacilli;Bacillales;Bacillaceae;Vulcanibacillus;unknown species
Cluster_160	cellular organisms;Archaea;Euryarchaeota;Thermococci;Methanofastidiosales;Methanofastidiosaceae;Candidatus Methanofastidiosum;unknown species
Cluster_161	cellular organisms;Bacteria;Firmicutes;Clostridia;Oscillospirales;Hungateiclostridiaceae;Fastidiosipila;Clostridiales bacterium feline oral taxon 339
Cluster_162	cellular organisms;Bacteria;Firmicutes;Clostridia;Christensenellales;Christensenellaceae;Christensenellaceae R-7 group;unknown species
Cluster_163	cellular organisms;Bacteria;Bacteroidota;Bacteroidia;Bacteroidales;Tannerellaceae;Macellibacteroides;Multi-affiliation
Cluster_166	cellular organisms;Bacteria;Firmicutes;Clostridia;Clostridiales;Clostridiaceae;Clostridium sensu stricto 8;unknown species
Cluster_167	cellular organisms;Bacteria;Bacteroidota;Bacteroidia;Bacteroidales;Dysgonomonadaceae;Proteiniphilum;unknown species
Cluster_168	cellular organisms;Bacteria;Firmicutes;Clostridia;Christensenellales;Christensenellaceae;Christensenellaceae R-7 group;metagenome
Cluster_169	cellular organisms;Bacteria;Firmicutes;Clostridia;Oscillospirales;Hungateiclostridiaceae;Ruminiclostridium;unknown species
Cluster_170	cellular organisms;Bacteria;Bacteroidota;Bacteroidia;Bacteroidales;Marinilabiliaceae;unknown genus;unknown species
Cluster_171	cellular organisms;Bacteria;Bacteroidota;Bacteroidia;Bacteroidales;Marinilabiliaceae;unknown genus;unknown species
Cluster_172	cellular organisms;Bacteria;Bacteroidota;Bacteroidia;Bacteroidales;Paludibacteraceae;unknown genus;unknown species
Cluster_173	cellular organisms;Bacteria;Firmicutes;Clostridia;Caldicoprobacterales;Caldicoprobacteraceae;Caldicoprobacter;Multi-affiliation
Cluster_174	cellular organisms;Bacteria;Firmicutes;Bacilli;Acholeplasmatales;Acholeplasmataceae;Acholeplasma;unknown species
Cluster_175	cellular organisms;Bacteria;Firmicutes;Clostridia;Peptostreptococcales-Tissierellales;Family XI;unknown genus;unknown species
Cluster_176	cellular organisms;Bacteria;Firmicutes;Clostridia;Peptostreptococcales-Tissierellales;Anaerovoracaceae;unknown genus;unknown species
Cluster_177	cellular organisms;Bacteria;Planctomycetota;Phycisphaerae;MSBL9;KCLunmb-38-53;unknown genus;unknown species
Cluster_179	cellular organisms;Bacteria;Firmicutes;Clostridia;Christensenellales;Christensenellaceae;Christensenellaceae R-7 group;unknown species
Cluster_180	cellular organisms;Bacteria;Firmicutes;Thermovenabulia;Thermovenabulales;unknown family;Tepidanaerobacter;unknown species
Cluster_181	cellular organisms;Bacteria;Bacteroidota;Bacteroidia;Bacteroidales;Bacteroidetes vadinHA17;unknown genus;Multi-affiliation
Cluster_182	cellular organisms;Bacteria;Synergistota;Synergistia;Synergistales;Synergistaceae;Aminobacterium;Aminobacterium colombiense
Cluster_183	cellular organisms;Bacteria;Synergistota;Synergistia;Synergistales;Synergistaceae;unknown genus;Multi-affiliation
Cluster_185	cellular organisms;Bacteria;Bacteroidota;Bacteroidia;Bacteroidales;Dysgonomonadaceae;Fermentimonas;unknown species
Cluster_186	cellular organisms;Bacteria;Firmicutes;Clostridia;Christensenellales;Christensenellaceae;Christensenellaceae R-7 group;unknown species
Cluster_187	cellular organisms;Bacteria;Firmicutes;Clostridia;Caldicoprobacterales;Caldicoprobacteraceae;Caldicoprobacter;Multi-affiliation
Cluster_188	cellular organisms;Bacteria;Desulfobacterota;Syntrophorhabdia;Syntrophorhabdales;Syntrophorhabdaceae;Syntrophorhabdus;unknown species
Cluster_190	cellular organisms;Bacteria;Bacteroidota;Bacteroidia;Bacteroidales;Bacteroidaceae;Bacteroides;Multi-affiliation
Cluster_191	cellular organisms;Bacteria;Caldatribacteriota;JS1;unknown order;unknown family;unknown genus;unknown species
Cluster_192	cellular organisms;Bacteria;Bacteroidota;Bacteroidia;Bacteroidales;Dysgonomonadaceae;Proteiniphilum;unknown species
Cluster_193	cellular organisms;Bacteria;Chloroflexi;Anaerolineae;Anaerolineales;Anaerolineaceae;ADurb.Bin120;Brevefilum fermentans
Cluster_194	cellular organisms;Bacteria;Firmicutes;Limnochordia;MBA03;unknown family;unknown genus;unknown species
Cluster_197	cellular organisms;Bacteria;Firmicutes;Clostridia;Peptostreptococcales-Tissierellales;Family XI;Tissierella;unknown species
Cluster_196	cellular organisms;Bacteria;Firmicutes;Clostridia;Peptostreptococcales-Tissierellales;Family XI;W5053;unknown species
Cluster_198	cellular organisms;Bacteria;Bacteroidota;Bacteroidia;Bacteroidales;Paludibacteraceae;unknown genus;unknown species
Cluster_199	cellular organisms;Bacteria;Firmicutes;Bacilli;Lactobacillales;Enterococcaceae;Enterococcus;Multi-affiliation
Cluster_200	cellular organisms;Bacteria;Firmicutes;Bacilli;Lactobacillales;Lactobacillaceae;Amylolactobacillus;Multi-affiliation
Cluster_201	cellular organisms;Bacteria;Bacteroidota;Bacteroidia;Bacteroidales;GZKB124;unknown genus;unknown species
Cluster_202	cellular organisms;Bacteria;Firmicutes;Bacilli;RF39;unknown family;unknown genus;unknown species
Cluster_207	cellular organisms;Bacteria;Firmicutes;Bacilli;Izemoplasmatales;unknown family;unknown genus;unknown species
Cluster_204	cellular organisms;Bacteria;Firmicutes;Bacilli;Erysipelotrichales;Erysipelatoclostridiaceae;Erysipelatoclostridium;Multi-affiliation
Cluster_205	cellular organisms;Bacteria;Bacteroidota;Bacteroidia;Bacteroidales;Dysgonomonadaceae;Proteiniphilum;unknown species
Cluster_206	cellular organisms;Archaea;Euryarchaeota;Methanobacteria;Methanobacteriales;Methanobacteriaceae;Methanobacterium;Multi-affiliation
Cluster_209	cellular organisms;Bacteria;Bacteroidota;Bacteroidia;Bacteroidales;Prolixibacteraceae;Mariniphaga;unknown species
Cluster_208	cellular organisms;Bacteria;Firmicutes;D8A-2;unknown order;unknown family;unknown genus;anaerobic digester metagenome
Cluster_211	cellular organisms;Bacteria;Bacteroidota;Bacteroidia;Bacteroidales;Paludibacteraceae;unknown genus;unknown species
Cluster_212	cellular organisms;Bacteria;Firmicutes;Clostridia;Lachnospirales;Lachnospiraceae;unknown genus;unknown species
Cluster_213	cellular organisms;Bacteria;Firmicutes;Clostridia;Oscillospirales;Hungateiclostridiaceae;Saccharofermentans;unknown species
Cluster_214	cellular organisms;Bacteria;Firmicutes;Clostridia;Clostridiales;Clostridiaceae;Clostridium sensu stricto 1;Multi-affiliation
Cluster_215	cellular organisms;Bacteria;Bacteroidota;Bacteroidia;Bacteroidales;Dysgonomonadaceae;Fermentimonas;unknown species
Cluster_216	cellular organisms;Bacteria;Verrucomicrobiota;Verrucomicrobiae;LD1-PB3;unknown family;unknown genus;unknown species
Cluster_217	cellular organisms;Bacteria;Firmicutes;Clostridia;Oscillospirales;Hungateiclostridiaceae;Saccharofermentans;unknown species
Cluster_218	cellular organisms;Bacteria;Firmicutes;Clostridia;Peptostreptococcales-Tissierellales;Sedimentibacteraceae;Sedimentibacter;unknown species
Cluster_220	cellular organisms;Bacteria;Bacteroidota;Bacteroidia;Bacteroidales;Bacteroidetes vadinHA17;unknown genus;unknown species
Cluster_223	cellular organisms;Bacteria;Thermotogota;Thermotogae;Petrotogales;Petrotogaceae;SC103;metagenome
Cluster_222	cellular organisms;Bacteria;Spirochaetota;MVP-15;unknown order;unknown family;unknown genus;unknown species
Cluster_221	cellular organisms;Bacteria;Firmicutes;Clostridia;Oscillospirales;Hungateiclostridiaceae;unknown genus;unknown species
Cluster_225	cellular organisms;Bacteria;Firmicutes;Clostridia;Peptostreptococcales-Tissierellales;Family XI;unknown genus;unknown species
Cluster_227	cellular organisms;Bacteria;Dependentiae;Babeliae;Babeliales;unknown family;unknown genus;unknown species
Cluster_229	cellular organisms;Bacteria;Firmicutes;Clostridia;Oscillospirales;Ruminococcaceae;[Eubacterium] siraeum group;unknown species
Cluster_230	cellular organisms;Bacteria;Firmicutes;Clostridia;Oscillospirales;Hungateiclostridiaceae;UCG-012;unknown species
Cluster_231	cellular organisms;Bacteria;Verrucomicrobiota;Verrucomicrobiae;Opitutales;Puniceicoccaceae;Puniceicoccus;unknown species
Cluster_232	cellular organisms;Bacteria;Cloacimonadota;Cloacimonadia;Cloacimonadales;Cloacimonadaceae;Candidatus Cloacimonas;unknown species
Cluster_234	cellular organisms;Bacteria;Firmicutes;Clostridia;Christensenellales;Christensenellaceae;Christensenellaceae R-7 group;unknown species
Cluster_235	cellular organisms;Bacteria;Firmicutes;Clostridia;Christensenellales;Christensenellaceae;Christensenellaceae R-7 group;unknown species
Cluster_236	cellular organisms;Bacteria;Firmicutes;Clostridia;Peptostreptococcales-Tissierellales;Family XI;Multi-affiliation;Multi-affiliation
Cluster_238	cellular organisms;Bacteria;Bacteroidota;Bacteroidia;Bacteroidales;M2PB4-65 termite group;unknown genus;unknown species
Cluster_237	cellular organisms;Bacteria;Firmicutes;Clostridia;Oscillospirales;Hungateiclostridiaceae;HN-HF0106;unknown species
Cluster_239	cellular organisms;Bacteria;Acidobacteriota;Subgroup 18;unknown order;unknown family;unknown genus;unknown species
Cluster_241	cellular organisms;Bacteria;Spirochaetota;Spirochaetia;Spirochaetales;Spirochaetaceae;Treponema;metagenome
Cluster_242	cellular organisms;Bacteria;Armatimonadota;Chthonomonadetes;Chthonomonadales;unknown family;unknown genus;unknown species
Cluster_243	cellular organisms;Bacteria;Bacteroidota;Bacteroidia;Bacteroidales;Dysgonomonadaceae;unknown genus;unknown species
Cluster_244	cellular organisms;Bacteria;Synergistota;Synergistia;Synergistales;Synergistaceae;Acetomicrobium;unknown species
Cluster_245	cellular organisms;Bacteria;Firmicutes;Clostridia;Eubacteriales;Eubacteriaceae;Acetobacterium;unknown species
Cluster_246	cellular organisms;Bacteria;Firmicutes;Bacilli;Erysipelotrichales;Erysipelotrichaceae;Erysipelothrix;unknown species
Cluster_247	cellular organisms;Bacteria;Bacteroidota;Bacteroidia;Bacteroidales;Rikenellaceae;unknown genus;unknown species
Cluster_250	cellular organisms;Bacteria;Firmicutes;Clostridia;Clostridiales;Clostridiaceae;Clostridium sensu stricto 1;Multi-affiliation
Cluster_251	cellular organisms;Bacteria;Firmicutes;Clostridia;Christensenellales;Christensenellaceae;Christensenellaceae R-7 group;unknown species
Cluster_252	cellular organisms;Bacteria;Firmicutes;Clostridia;Peptostreptococcales-Tissierellales;Family XI;Tissierella;unknown species
Cluster_254	cellular organisms;Bacteria;Firmicutes;Clostridia;Christensenellales;Christensenellaceae;Christensenellaceae R-7 group;Multi-affiliation
Cluster_256	cellular organisms;Bacteria;Hydrogenedentes;Hydrogenedentia;Hydrogenedentiales;Hydrogenedensaceae;YC-ZSS-LKJ63;unknown species
Cluster_258	cellular organisms;Bacteria;Firmicutes;Clostridia;Lachnospirales;Lachnospiraceae;[Eubacterium] ventriosum group;unknown species
Cluster_259	cellular organisms;Bacteria;Firmicutes;Clostridia;Peptostreptococcales-Tissierellales;Family XI;W5053;unknown species
Cluster_261	cellular organisms;Bacteria;Bacteroidota;Bacteroidia;Bacteroidales;Paludibacteraceae;unknown genus;unknown species
Cluster_260	cellular organisms;Bacteria;Firmicutes;Clostridia;Caldicoprobacterales;Caldicoprobacteraceae;Caldicoprobacter;Multi-affiliation
Cluster_262	cellular organisms;Bacteria;Firmicutes;Clostridia;Clostridiales;Clostridiaceae;Clostridium sensu stricto 1;unknown species
Cluster_263	cellular organisms;Bacteria;Firmicutes;Clostridia;Oscillospirales;Hungateiclostridiaceae;HN-HF0106;metagenome
Cluster_264	cellular organisms;Bacteria;Cloacimonadota;Cloacimonadia;Cloacimonadales;Cloacimonadaceae;W5;unknown species
Cluster_265	cellular organisms;Bacteria;Firmicutes;Clostridia;Caldicoprobacterales;Caldicoprobacteraceae;Caldicoprobacter;unknown species
Cluster_266	cellular organisms;Bacteria;Firmicutes;Dethiobacteria;Dethiobacterales;Dethiobacteraceae;unknown genus;unknown species
Cluster_267	cellular organisms;Bacteria;Planctomycetota;Planctomycetes;Pirellulales;Pirellulaceae;Pir4 lineage;unknown species
Cluster_269	cellular organisms;Bacteria;Firmicutes;Clostridia;Oscillospirales;UCG-010;unknown genus;unknown species
Cluster_270	cellular organisms;Bacteria;Cloacimonadota;Cloacimonadia;Cloacimonadales;Cloacimonadaceae;Candidatus Cloacimonas;unknown species
Cluster_271	cellular organisms;Bacteria;Firmicutes;Clostridia;Oscillospirales;Oscillospiraceae;Papillibacter;unknown species
Cluster_272	cellular organisms;Bacteria;Proteobacteria;Gammaproteobacteria;Pseudomonadales;Moraxellaceae;Psychrobacter;Multi-affiliation
Cluster_275	cellular organisms;Bacteria;Firmicutes;Clostridia;Eubacteriales;Garciellaceae;Irregularibacter;unknown species
Cluster_277	cellular organisms;Bacteria;Firmicutes;Bacilli;Lactobacillales;Streptococcaceae;Streptococcus;Multi-affiliation
Cluster_278	cellular organisms;Bacteria;Bacteroidota;Bacteroidia;Bacteroidales;Dysgonomonadaceae;Proteiniphilum;unknown species
Cluster_279	cellular organisms;Bacteria;Firmicutes;Clostridia;Oscillospirales;[Eubacterium] coprostanoligenes group;unknown genus;unknown species
Cluster_280	cellular organisms;Bacteria;Cloacimonadota;Cloacimonadia;Cloacimonadales;Cloacimonadaceae;W5;unknown species
Cluster_281	cellular organisms;Bacteria;Firmicutes;Clostridia;unknown order;Gracilibacteraceae;Lutispora;unknown species
Cluster_282	cellular organisms;Bacteria;Firmicutes;Bacilli;Erysipelotrichales;Erysipelotrichaceae;unknown genus;Erysipelotrichaceae bacterium canine oral taxon 302
Cluster_283	cellular organisms;Bacteria;Desulfobacterota;Syntrophia;Syntrophales;Smithellaceae;Smithella;unknown species
Cluster_284	cellular organisms;Bacteria;Cloacimonadota;Cloacimonadia;Cloacimonadales;Cloacimonadaceae;W5;unknown species
Cluster_286	cellular organisms;Bacteria;Caldatribacteriota;JS1;unknown order;unknown family;unknown genus;unknown species
Cluster_288	cellular organisms;Bacteria;Firmicutes;Bacilli;Izemoplasmatales;unknown family;unknown genus;unknown species
Cluster_287	cellular organisms;Bacteria;Firmicutes;Clostridia;Christensenellales;Christensenellaceae;Christensenellaceae R-7 group;unknown species
Cluster_289	cellular organisms;Bacteria;Firmicutes;Clostridia;Christensenellales;Christensenellaceae;Christensenellaceae R-7 group;unknown species
Cluster_292	cellular organisms;Bacteria;Firmicutes;Negativicutes;Veillonellales-Selenomonadales;Selenomonadaceae;unknown genus;unknown species
Cluster_293	cellular organisms;Bacteria;Chloroflexi;Anaerolineae;Anaerolineales;Anaerolineaceae;unknown genus;Multi-affiliation
Cluster_294	cellular organisms;Bacteria;Firmicutes;Clostridia;Peptostreptococcales-Tissierellales;Family XI;Tissierella;unknown species
Cluster_295	cellular organisms;Bacteria;Chloroflexi;Anaerolineae;Anaerolineales;Anaerolineaceae;unknown genus;Multi-affiliation
Cluster_299	cellular organisms;Bacteria;Firmicutes;Clostridia;Peptostreptococcales-Tissierellales;Family XI;Gallicola;Peptostreptococcaceae bacterium SK031
Cluster_303	cellular organisms;Bacteria;Firmicutes;Clostridia;Caldicoprobacterales;Caldicoprobacteraceae;Caldicoprobacter;unknown species
Cluster_302	cellular organisms;Bacteria;Firmicutes;Clostridia;Oscillospirales;Hungateiclostridiaceae;Fastidiosipila;unknown species
Cluster_305	cellular organisms;Bacteria;Firmicutes;Clostridia;Oscillospirales;[Eubacterium] coprostanoligenes group;unknown genus;unknown species
Cluster_306	cellular organisms;Bacteria;Firmicutes;Clostridia;Peptococcales;Peptococcaceae;unknown genus;unknown species
Cluster_309	cellular organisms;Bacteria;Firmicutes;Desulfotomaculia;Desulfotomaculales;Pelotomaculaceae;Pelotomaculum;unknown species
Cluster_308	cellular organisms;Archaea;Halobacterota;Methanomicrobia;Methanomicrobiales;Methanocorpusculaceae;Methanocorpusculum;unknown species
Cluster_311	cellular organisms;Bacteria;Firmicutes;Clostridia;Christensenellales;Christensenellaceae;Christensenellaceae R-7 group;Multi-affiliation
Cluster_312	cellular organisms;Bacteria;Firmicutes;Clostridia;Oscillospirales;Ruminococcaceae;Candidatus Soleaferrea;unknown species
Cluster_316	cellular organisms;Bacteria;Firmicutes;Clostridia;Peptostreptococcales-Tissierellales;Sedimentibacteraceae;Sedimentibacter;unknown species
Cluster_318	cellular organisms;Bacteria;Bacteroidota;Bacteroidia;Bacteroidales;Prolixibacteraceae;unknown genus;unknown species
Cluster_320	cellular organisms;Bacteria;Firmicutes;Clostridia;Peptostreptococcales-Tissierellales;Family XI;Tissierella;unknown species
Cluster_321	cellular organisms;Bacteria;Firmicutes;Thermovenabulia;Thermovenabulales;unknown family;Tepidanaerobacter;unknown species
Cluster_323	cellular organisms;Bacteria;Actinobacteriota;Actinobacteria;Actinomycetales;Actinomycetaceae;Actinomyces;unknown species
Cluster_322	cellular organisms;Bacteria;Firmicutes;Clostridia;Lachnospirales;Lachnospiraceae;Lachnospiraceae XPB1014 group;unknown species
Cluster_326	cellular organisms;Bacteria;Firmicutes;Clostridia;Clostridiales;Clostridiaceae;Clostridium sensu stricto 8;unknown species
Cluster_327	cellular organisms;Bacteria;Bacteroidota;Bacteroidia;Bacteroidales;Bacteroidales UCG-001;unknown genus;unknown species
Cluster_328	cellular organisms;Bacteria;Thermotogota;Thermotogae;Petrotogales;Petrotogaceae;SC103;metagenome
Cluster_331	cellular organisms;Bacteria;Firmicutes;Clostridia;Christensenellales;Christensenellaceae;Christensenellaceae R-7 group;unknown species
Cluster_333	cellular organisms;Bacteria;Firmicutes;Clostridia;Christensenellales;Christensenellaceae;Christensenellaceae R-7 group;metagenome
Cluster_334	cellular organisms;Bacteria;Bacteroidota;Bacteroidia;Bacteroidales;Marinilabiliaceae;Ruminofilibacter;Multi-affiliation
Cluster_336	cellular organisms;Bacteria;Firmicutes;Clostridia;Peptostreptococcales-Tissierellales;Peptostreptococcaceae;Intestinibacter;unknown species
Cluster_337	cellular organisms;Bacteria;Cloacimonadota;Cloacimonadia;Cloacimonadales;Cloacimonadaceae;W5;unknown species
Cluster_338	cellular organisms;Bacteria;Firmicutes;Clostridia;Oscillospirales;Ruminococcaceae;Ruminococcus;unknown species
Cluster_340	cellular organisms;Bacteria;Firmicutes;Clostridia;Christensenellales;Christensenellaceae;Christensenellaceae R-7 group;Multi-affiliation
Cluster_342	cellular organisms;Bacteria;Firmicutes;Clostridia;Oscillospirales;[Eubacterium] coprostanoligenes group;unknown genus;unknown species
Cluster_343	cellular organisms;Bacteria;Firmicutes;Syntrophomonadia;Syntrophomonadales;Syntrophomonadaceae;Syntrophomonas;unknown species
Cluster_349	cellular organisms;Bacteria;Proteobacteria;Gammaproteobacteria;Pseudomonadales;Pseudomonadaceae;Pseudomonas;Pseudomonas formosensis
Cluster_348	cellular organisms;Bacteria;Firmicutes;Clostridia;Oscillospirales;UCG-010;unknown genus;unknown species
Cluster_351	cellular organisms;Bacteria;Spirochaetota;Spirochaetia;Spirochaetales;Spirochaetaceae;Sphaerochaeta;unknown species
Cluster_350	cellular organisms;Bacteria;Firmicutes;Clostridia;Lachnospirales;Lachnospiraceae;unknown genus;unknown species
Cluster_352	cellular organisms;Bacteria;Firmicutes;Thermovenabulia;Thermovenabulales;unknown family;Tepidanaerobacter;unknown species
Cluster_354	cellular organisms;Bacteria;Firmicutes;Clostridia;Oscillospirales;Hungateiclostridiaceae;HN-HF0106;unknown species
Cluster_356	cellular organisms;Bacteria;Firmicutes;Bacilli;RF39;unknown family;unknown genus;unknown species
Cluster_357	cellular organisms;Bacteria;Firmicutes;Clostridia;Eubacteriales;Eubacteriaceae;Acetobacterium;unknown species
Cluster_358	cellular organisms;Bacteria;Firmicutes;Clostridia;Peptostreptococcales-Tissierellales;Anaerovoracaceae;Anaerovorax;unknown species
Cluster_360	cellular organisms;Bacteria;Planctomycetota;Phycisphaerae;CCM11a;unknown family;unknown genus;bacterium enrichment culture clone E27
Cluster_359	cellular organisms;Bacteria;Firmicutes;Clostridia;Caldicoprobacterales;Caldicoprobacteraceae;Caldicoprobacter;Multi-affiliation
Cluster_361	cellular organisms;Archaea;Euryarchaeota;Methanobacteria;Methanobacteriales;Methanobacteriaceae;Methanobacterium;unknown species
Cluster_362	cellular organisms;Bacteria;Bacteroidota;Bacteroidia;Bacteroidales;Dysgonomonadaceae;Proteiniphilum;Multi-affiliation
Cluster_364	cellular organisms;Bacteria;Planctomycetota;Planctomycetes;Pirellulales;Pirellulaceae;p-1088-a5 gut group;unknown species
Cluster_365	cellular organisms;Bacteria;Bacteroidota;Bacteroidia;Bacteroidales;Dysgonomonadaceae;Proteiniphilum;unknown species
Cluster_366	cellular organisms;Bacteria;Firmicutes;Clostridia;unknown order;unknown family;unknown genus;unknown species
Cluster_367	cellular organisms;Bacteria;Firmicutes;Clostridia;Caldicoprobacterales;Caldicoprobacteraceae;Caldicoprobacter;Multi-affiliation
Cluster_369	cellular organisms;Bacteria;Chloroflexi;Anaerolineae;RBG-13-54-9;unknown family;unknown genus;unknown species
Cluster_370	cellular organisms;Bacteria;Thermotogota;Thermotogae;Kosmotogales;Kosmotogaceae;Mesotoga;Mesotoga infera
Cluster_375	cellular organisms;Bacteria;Bacteroidota;Bacteroidia;Bacteroidales;Bacteroidetes vadinHA17;unknown genus;unknown species
Cluster_374	cellular organisms;Archaea;Halobacterota;Methanomicrobia;Methanomicrobiales;Methanospirillaceae;Methanospirillum;unknown species
Cluster_376	cellular organisms;Bacteria;Firmicutes;Clostridia;Peptostreptococcales-Tissierellales;Family XI;Tissierella;unknown species
Cluster_378	cellular organisms;Bacteria;Firmicutes;Clostridia;Clostridiales;Clostridiaceae;Multi-affiliation;Multi-affiliation
Cluster_379	cellular organisms;Bacteria;Firmicutes;Moorellia;Desulfitibacterales;Desulfitibacteraceae;Desulfitibacter;unknown species
Cluster_382	cellular organisms;Bacteria;Actinobacteriota;Actinobacteria;Actinomycetales;Actinomycetaceae;Actinomyces;Gleimia europaea
Cluster_383	cellular organisms;Bacteria;Firmicutes;Syntrophomonadia;Syntrophomonadales;Syntrophomonadaceae;Syntrophomonas;unknown species
Cluster_384	cellular organisms;Bacteria;Firmicutes;Clostridia;Oscillospirales;Hungateiclostridiaceae;HN-HF0106;metagenome
Cluster_388	cellular organisms;Bacteria;Bacteroidota;Bacteroidia;Bacteroidales;Marinilabiliaceae;Ruminofilibacter;Multi-affiliation
Cluster_387	cellular organisms;Bacteria;Firmicutes;unknown class;unknown order;unknown family;Gelria;unknown species
Cluster_386	cellular organisms;Bacteria;Firmicutes;Desulfitobacteriia;Desulfitobacteriales;Syntrophobotulaceae;Dehalobacter;unknown species
Cluster_390	cellular organisms;Bacteria;Spirochaetota;Spirochaetia;Spirochaetales;Spirochaetaceae;Treponema;unknown species
Cluster_393	cellular organisms;Bacteria;Firmicutes;Clostridia;Lachnospirales;Lachnospiraceae;unknown genus;unknown species
Cluster_397	cellular organisms;Bacteria;Firmicutes;Clostridia;Oscillospirales;Hungateiclostridiaceae;HN-HF0106;metagenome
Cluster_399	cellular organisms;Bacteria;Armatimonadota;unknown class;unknown order;unknown family;unknown genus;unknown species
Cluster_401	cellular organisms;Bacteria;Firmicutes;Clostridia;Caldicoprobacterales;Caldicoprobacteraceae;Caldicoprobacter;Multi-affiliation
Cluster_404	cellular organisms;Bacteria;Chloroflexi;Anaerolineae;Anaerolineales;Anaerolineaceae;ADurb.Bin120;Brevefilum fermentans
Cluster_408	cellular organisms;Bacteria;Firmicutes;Bacilli;Erysipelotrichales;Erysipelotrichaceae;Erysipelothrix;unknown species
Cluster_415	cellular organisms;Bacteria;Firmicutes;Clostridia;Peptostreptococcales-Tissierellales;Family XI;unknown genus;unknown species
Cluster_413	cellular organisms;Bacteria;Bacteroidota;Bacteroidia;Bacteroidales;Dysgonomonadaceae;Proteiniphilum;unknown species
Cluster_416	cellular organisms;Bacteria;Firmicutes;Syntrophomonadia;Syntrophomonadales;Syntrophomonadaceae;Syntrophomonas;Syntrophomonas wolfei
Cluster_420	cellular organisms;Bacteria;Bacteroidota;Bacteroidia;Bacteroidales;Rikenellaceae;Rikenellaceae RC9 gut group;unknown species
Cluster_419	cellular organisms;Bacteria;Firmicutes;Dethiobacteria;Dethiobacterales;Dethiobacteraceae;Dethiobacter;anaerobic digester metagenome
Cluster_418	cellular organisms;Bacteria;Firmicutes;unknown class;unknown order;unknown family;unknown genus;unknown species
Cluster_427	cellular organisms;Bacteria;Firmicutes;Clostridia;Peptostreptococcales-Tissierellales;Sedimentibacteraceae;Sedimentibacter;unknown species
Cluster_426	cellular organisms;Bacteria;Firmicutes;Clostridia;Lachnospirales;Lachnospiraceae;Cellulosilyticum;unknown species
Cluster_433	cellular organisms;Bacteria;Firmicutes;Clostridia;Lachnospirales;Lachnospiraceae;Anaerostignum;Anaerotignum aminivorans
Cluster_429	cellular organisms;Bacteria;Firmicutes;Clostridia;Oscillospirales;Hungateiclostridiaceae;Fastidiosipila;unknown species
Cluster_432	cellular organisms;Bacteria;Chloroflexi;Anaerolineae;Anaerolineales;Anaerolineaceae;unknown genus;Multi-affiliation
Cluster_430	cellular organisms;Bacteria;Firmicutes;Clostridia;Oscillospirales;Hungateiclostridiaceae;unknown genus;unknown species
Cluster_435	cellular organisms;Archaea;Nanoarchaeota;Nanoarchaeia;Woesearchaeales;unknown family;unknown genus;unknown species
Cluster_441	cellular organisms;Bacteria;Firmicutes;Clostridia;Peptostreptococcales-Tissierellales;Sedimentibacteraceae;Sedimentibacter;unknown species
Cluster_442	cellular organisms;Bacteria;Synergistota;Synergistia;Synergistales;Synergistaceae;unknown genus;unknown species
Cluster_440	cellular organisms;Bacteria;Actinobacteriota;Actinobacteria;Micrococcales;Bogoriellaceae;Georgenia;unknown species
Cluster_449	cellular organisms;Bacteria;Firmicutes;Clostridia;Caldicoprobacterales;Caldicoprobacteraceae;Caldicoprobacter;Multi-affiliation
Cluster_455	cellular organisms;Bacteria;Firmicutes;Clostridia;Peptostreptococcales-Tissierellales;unknown family;Alkaliphilus;unknown species
Cluster_452	cellular organisms;Bacteria;Bacteroidota;Bacteroidia;Bacteroidales;PeH15;unknown genus;unknown species
Cluster_453	cellular organisms;Bacteria;Bacteroidota;Bacteroidia;Bacteroidales;Bacteroidetes vadinHA17;unknown genus;unknown species
Cluster_461	cellular organisms;Bacteria;Bacteroidota;Bacteroidia;Bacteroidales;Rikenellaceae;DMER64;unknown species
Cluster_460	cellular organisms;Bacteria;Firmicutes;Clostridia;Oscillospirales;UCG-010;unknown genus;bacterium enrichment culture clone BBMC-9
Cluster_462	cellular organisms;Bacteria;Firmicutes;Limnochordia;MBA03;unknown family;unknown genus;unknown species
Cluster_463	cellular organisms;Bacteria;Firmicutes;Limnochordia;MBA03;unknown family;unknown genus;Multi-affiliation
Cluster_465	cellular organisms;Bacteria;Firmicutes;Clostridia;Caldicoprobacterales;Caldicoprobacteraceae;Caldicoprobacter;unknown species
Cluster_472	cellular organisms;Bacteria;Actinobacteriota;Actinobacteria;Propionibacteriales;Propionibacteriaceae;Propioniciclava;Multi-affiliation
Cluster_469	cellular organisms;Bacteria;Firmicutes;Clostridia;unknown order;Gracilibacteraceae;Lutispora;unknown species
Cluster_470	cellular organisms;Bacteria;Firmicutes;Syntrophomonadia;Syntrophomonadales;Syntrophomonadaceae;unknown genus;unknown species
Cluster_482	cellular organisms;Bacteria;Firmicutes;Clostridia;Oscillospirales;[Eubacterium] coprostanoligenes group;unknown genus;unknown species
Cluster_480	cellular organisms;Bacteria;Firmicutes;Clostridia;Peptococcales;Peptococcaceae;unknown genus;unknown species
Cluster_479	cellular organisms;Bacteria;Firmicutes;Syntrophomonadia;Syntrophomonadales;Syntrophomonadaceae;unknown genus;Multi-affiliation
Cluster_486	cellular organisms;Bacteria;Bacteroidota;Bacteroidia;Sphingobacteriales;ST-12K33;unknown genus;metagenome
Cluster_485	cellular organisms;Bacteria;Firmicutes;Clostridia;Lachnospirales;Lachnospiraceae;Herbinix;unknown species
Cluster_489	cellular organisms;Bacteria;Bacteroidota;Bacteroidia;Sphingobacteriales;ST-12K33;unknown genus;metagenome
Cluster_494	cellular organisms;Bacteria;Firmicutes;Clostridia;Clostridiales;Clostridiaceae;Clostridium sensu stricto 8;unknown species
Cluster_499	cellular organisms;Bacteria;Proteobacteria;Gammaproteobacteria;Burkholderiales;Alcaligenaceae;Pusillimonas;unknown species
Cluster_500	cellular organisms;Bacteria;Firmicutes;Clostridia;Clostridiales;Clostridiaceae;Clostridium sensu stricto 1;Multi-affiliation
Cluster_503	cellular organisms;Bacteria;Firmicutes;Clostridia;Peptostreptococcales-Tissierellales;Anaerovoracaceae;unknown genus;anaerobic digester metagenome
Cluster_506	cellular organisms;Bacteria;Firmicutes;Desulfitobacteriia;Desulfitobacteriales;Syntrophobotulaceae;Candidatus Dichloromethanomonas;unknown species
Cluster_513	cellular organisms;Bacteria;Firmicutes;Clostridia;Peptostreptococcales-Tissierellales;unknown family;Natronincola;Natronincola peptidivorans
Cluster_510	cellular organisms;Bacteria;Firmicutes;Desulfotomaculia;Desulfotomaculales;Pelotomaculaceae;Cryptanaerobacter;unknown species
Cluster_512	cellular organisms;Bacteria;Firmicutes;Clostridia;Oscillospirales;Hungateiclostridiaceae;Saccharofermentans;unknown species
Cluster_515	cellular organisms;Bacteria;Firmicutes;Clostridia;Peptostreptococcales-Tissierellales;Anaerovoracaceae;Anaerovorax;unknown species
Cluster_523	cellular organisms;Bacteria;Firmicutes;Clostridia;Lachnospirales;Lachnospiraceae;unknown genus;unknown species
Cluster_521	cellular organisms;Bacteria;Firmicutes;Clostridia;Peptococcales;Peptococcaceae;unknown genus;unknown species
Cluster_520	cellular organisms;Bacteria;Caldatribacteriota;JS1;unknown order;unknown family;unknown genus;unknown species
Cluster_519	cellular organisms;Bacteria;Firmicutes;Clostridia;Oscillospirales;Hungateiclostridiaceae;Acetivibrio;Multi-affiliation
Cluster_527	cellular organisms;Bacteria;Firmicutes;Bacilli;Erysipelotrichales;Erysipelotrichaceae;[Anaerorhabdus] furcosa group;unknown species
Cluster_526	cellular organisms;Archaea;Halobacterota;Methanomicrobia;Methanomicrobiales;Methanospirillaceae;Methanospirillum;unknown species
Cluster_532	cellular organisms;Bacteria;Synergistota;Synergistia;Synergistales;Synergistaceae;Aminivibrio;Multi-affiliation
Cluster_544	cellular organisms;Bacteria;Firmicutes;Clostridia;Christensenellales;Christensenellaceae;Christensenellaceae R-7 group;unknown species
Cluster_549	cellular organisms;Bacteria;Firmicutes;Clostridia;Christensenellales;Christensenellaceae;Christensenellaceae R-7 group;unknown species
Cluster_551	cellular organisms;Bacteria;Firmicutes;Clostridia;Caldicoprobacterales;Caldicoprobacteraceae;Caldicoprobacter;unknown species
Cluster_567	cellular organisms;Bacteria;Firmicutes;Clostridia;Oscillospirales;Hungateiclostridiaceae;Fastidiosipila;unknown species
Cluster_571	cellular organisms;Bacteria;Synergistota;Synergistia;Synergistales;Synergistaceae;unknown genus;unknown species
Cluster_570	cellular organisms;Bacteria;Firmicutes;Clostridia;Oscillospirales;[Eubacterium] coprostanoligenes group;unknown genus;unknown species
Cluster_569	cellular organisms;Bacteria;Actinobacteriota;Thermoleophilia;Gaiellales;unknown family;unknown genus;unknown species
Cluster_578	cellular organisms;Bacteria;Firmicutes;Clostridia;Oscillospirales;Hungateiclostridiaceae;Fastidiosipila;unknown species
Cluster_588	cellular organisms;Bacteria;Bacteroidota;Bacteroidia;Sphingobacteriales;ST-12K33;unknown genus;metagenome
Cluster_593	cellular organisms;Bacteria;Firmicutes;Clostridia;Lachnospirales;Lachnospiraceae;Epulopiscium;unknown species
Cluster_604	cellular organisms;Bacteria;Bacteroidota;Bacteroidia;Bacteroidales;Bacteroidetes vadinHA17;unknown genus;unknown species
Cluster_603	cellular organisms;Bacteria;Firmicutes;Clostridia;Lachnospirales;Lachnospiraceae;Multi-affiliation;Multi-affiliation
Cluster_600	cellular organisms;Bacteria;Actinobacteriota;Actinobacteria;Propionibacteriales;Propionibacteriaceae;Propioniciclava;Multi-affiliation
Cluster_608	cellular organisms;Bacteria;Firmicutes;Syntrophomonadia;Syntrophomonadales;Syntrophomonadaceae;unknown genus;unknown species
Cluster_609	cellular organisms;Bacteria;Desulfobacterota;Desulfobulbia;Desulfobulbales;Desulfobulbaceae;Desulfobulbus;unknown species
Cluster_616	cellular organisms;Bacteria;Synergistota;Synergistia;Synergistales;Synergistaceae;unknown genus;unknown species
Cluster_622	cellular organisms;Bacteria;Firmicutes;Clostridia;Christensenellales;Christensenellaceae;Christensenellaceae R-7 group;unknown species
Cluster_632	cellular organisms;Bacteria;Firmicutes;Bacilli;Desulfuribacillales;Desulfuribacillaceae;Desulfuribacillus;Bacillus sp.
Cluster_654	cellular organisms;Bacteria;Firmicutes;Dethiobacteria;Dethiobacterales;Dethiobacteraceae;unknown genus;unknown species
Cluster_658	cellular organisms;Bacteria;Firmicutes;Clostridia;Peptostreptococcales-Tissierellales;Peptostreptococcaceae;Intestinibacter;Multi-affiliation
Cluster_659	cellular organisms;Bacteria;Firmicutes;Syntrophomonadia;Syntrophomonadales;Syntrophomonadaceae;unknown genus;unknown species
Cluster_668	cellular organisms;Bacteria;Bacteroidota;Bacteroidia;Bacteroidales;Paludibacteraceae;unknown genus;unknown species
Cluster_664	cellular organisms;Bacteria;Firmicutes;Clostridia;Clostridiales;Clostridiaceae;Sarcina;unknown species
Cluster_667	cellular organisms;Bacteria;Firmicutes;Clostridia;Oscillospirales;Hungateiclostridiaceae;unknown genus;unknown species
Cluster_680	cellular organisms;Bacteria;Firmicutes;Clostridia;Oscillospirales;Hungateiclostridiaceae;unknown genus;unknown species
Cluster_697	cellular organisms;Bacteria;Bacteroidota;Bacteroidia;Bacteroidales;Paludibacteraceae;unknown genus;unknown species
Cluster_694	cellular organisms;Bacteria;Synergistota;Synergistia;Synergistales;Synergistaceae;unknown genus;Multi-affiliation
Cluster_705	cellular organisms;Bacteria;Chloroflexi;Anaerolineae;Anaerolineales;Anaerolineaceae;unknown genus;unknown species
Cluster_721	cellular organisms;Bacteria;Actinobacteriota;Actinobacteria;Actinomycetales;Actinomycetaceae;Actinomyces;bacterium NLAE-zl-C91
Cluster_718	cellular organisms;Bacteria;Firmicutes;Clostridia;Oscillospirales;Hungateiclostridiaceae;Fastidiosipila;unknown species
Cluster_715	cellular organisms;Bacteria;Actinobacteriota;Actinobacteria;Propionibacteriales;Propionibacteriaceae;Raineyella;unknown species
Cluster_714	cellular organisms;Archaea;Euryarchaeota;Methanobacteria;Methanobacteriales;Methanobacteriaceae;Methanobacterium;unknown species
Cluster_725	cellular organisms;Bacteria;Synergistota;Synergistia;Synergistales;Synergistaceae;unknown genus;unknown species
Cluster_729	cellular organisms;Bacteria;Chloroflexi;Anaerolineae;Anaerolineales;Anaerolineaceae;Flexilinea;unknown species
Cluster_724	cellular organisms;Bacteria;Firmicutes;Limnochordia;M55-D21;unknown family;unknown genus;unknown species
Cluster_731	cellular organisms;Bacteria;Patescibacteria;Gracilibacteria;Absconditabacteriales (SR1);unknown family;unknown genus;unknown species
Cluster_737	cellular organisms;Bacteria;Proteobacteria;Gammaproteobacteria;Burkholderiales;Alcaligenaceae;Paenalcaligenes;Paenalcaligenes hermetiae
Cluster_738	cellular organisms;Bacteria;Firmicutes;Clostridia;Oscillospirales;Hungateiclostridiaceae;Fastidiosipila;unknown species
Cluster_741	cellular organisms;Bacteria;Firmicutes;Clostridia;Oscillospirales;Hungateiclostridiaceae;Ercella;unknown species
Cluster_754	cellular organisms;Bacteria;Firmicutes;Clostridia;Oscillospirales;Ruminococcaceae;Ruminococcus;unknown species
Cluster_770	cellular organisms;Bacteria;Firmicutes;Limnochordia;MBA03;unknown family;unknown genus;unknown species
Cluster_779	cellular organisms;Bacteria;Firmicutes;Clostridia;Peptostreptococcales-Tissierellales;Sedimentibacteraceae;Sedimentibacter;unknown species
Cluster_795	cellular organisms;Bacteria;Firmicutes;Clostridia;Oscillospirales;Hungateiclostridiaceae;Ruminiclostridium;unknown species
Cluster_807	cellular organisms;Bacteria;Firmicutes;Clostridia;Caldicoprobacterales;Caldicoprobacteraceae;Caldicoprobacter;unknown species
Cluster_801	cellular organisms;Bacteria;Firmicutes;Clostridia;unknown order;unknown family;unknown genus;unknown species
Cluster_820	cellular organisms;Bacteria;Caldatribacteriota;JS1;unknown order;unknown family;unknown genus;unknown species
Cluster_816	cellular organisms;Archaea;Euryarchaeota;Methanobacteria;Methanobacteriales;Methanobacteriaceae;Methanobacterium;unknown species
Cluster_825	cellular organisms;Bacteria;Bacteroidota;Bacteroidia;Bacteroidales;Paludibacteraceae;unknown genus;metagenome
Cluster_844	cellular organisms;Bacteria;Firmicutes;Clostridia;Peptostreptococcales-Tissierellales;Sedimentibacteraceae;Sedimentibacter;unknown species
Cluster_847	cellular organisms;Bacteria;Firmicutes;Clostridia;Oscillospirales;Hungateiclostridiaceae;UCG-012;unknown species
Cluster_866	cellular organisms;Bacteria;Bacteroidota;Bacteroidia;Bacteroidales;Dysgonomonadaceae;unknown genus;unknown species
Cluster_867	cellular organisms;Bacteria;Firmicutes;Clostridia;Lachnospirales;Defluviitaleaceae;Defluviitalea;unknown species
Cluster_874	cellular organisms;Bacteria;Actinobacteriota;Actinobacteria;Actinomycetales;Actinomycetaceae;Actinomyces;Schaalia canis
Cluster_885	cellular organisms;Bacteria;Firmicutes;Clostridia;Lachnospirales;Lachnospiraceae;Herbinix;unknown species
Cluster_904	cellular organisms;Bacteria;Fibrobacterota;Fibrobacteria;Fibrobacterales;Fibrobacteraceae;Fibrobacter;unknown species
Cluster_905	cellular organisms;Bacteria;Firmicutes;Limnochordia;MBA03;unknown family;unknown genus;unknown species
Cluster_992	cellular organisms;Bacteria;Actinobacteriota;Actinobacteria;Actinomycetales;Actinomycetaceae;Actinomyces;Gleimia europaea
Cluster_999	cellular organisms;Bacteria;Chloroflexi;Anaerolineae;Anaerolineales;Anaerolineaceae;unknown genus;unknown species
Cluster_1000	cellular organisms;Bacteria;Desulfobacterota;Desulfobulbia;Desulfobulbales;Desulfobulbaceae;Desulfobulbus;unknown species
Cluster_989	cellular organisms;Bacteria;Firmicutes;Clostridia;Oscillospirales;Hungateiclostridiaceae;Fastidiosipila;Clostridiales bacterium feline oral taxon 339
Cluster_1020	cellular organisms;Bacteria;Firmicutes;Clostridia;Peptostreptococcales-Tissierellales;Sedimentibacteraceae;Sedimentibacter;unknown species
Cluster_1037	cellular organisms;Bacteria;Firmicutes;Clostridia;Oscillospirales;Hungateiclostridiaceae;Fastidiosipila;unknown species
Cluster_1122	cellular organisms;Bacteria;Firmicutes;Clostridia;Oscillospirales;unknown family;unknown genus;unknown species
Cluster_1130	cellular organisms;Bacteria;Patescibacteria;Gracilibacteria;Absconditabacteriales (SR1);unknown family;unknown genus;unknown species
Cluster_1129	cellular organisms;Bacteria;Firmicutes;Clostridia;Oscillospirales;Hungateiclostridiaceae;Fastidiosipila;unknown species
Cluster_1180	cellular organisms;Bacteria;Firmicutes;Clostridia;Oscillospirales;Hungateiclostridiaceae;Saccharofermentans;unknown species
Cluster_1238	cellular organisms;Bacteria;Firmicutes;Limnochordia;unknown order;unknown family;unknown genus;Multi-affiliation
Cluster_1330	cellular organisms;Bacteria;Synergistota;Synergistia;Synergistales;Synergistaceae;Thermovirga;metagenome
Cluster_1321	cellular organisms;Bacteria;Firmicutes;Clostridia;Clostridia vadinBB60 group;unknown family;unknown genus;unknown species
Cluster_1430	cellular organisms;Bacteria;Proteobacteria;Gammaproteobacteria;Pseudomonadales;Pseudomonadaceae;Thiopseudomonas;unknown species
Cluster_1387	cellular organisms;Bacteria;Firmicutes;Moorellia;Desulfitibacterales;Desulfitibacteraceae;Desulfitibacter;unknown species
Cluster_1613	cellular organisms;Bacteria;Bacteroidota;Bacteroidia;Sphingobacteriales;ST-12K33;unknown genus;metagenome
Cluster_1626	cellular organisms;Bacteria;Firmicutes;Clostridia;Oscillospirales;Hungateiclostridiaceae;Ruminiclostridium;unknown species
Cluster_1852	cellular organisms;Bacteria;Firmicutes;Clostridia;Lachnospirales;Lachnospiraceae;Herbinix;unknown species
Cluster_2436	cellular organisms;Bacteria;Proteobacteria;Gammaproteobacteria;Burkholderiales;Comamonadaceae;Comamonas;Comamonas sp.
Cluster_2611	cellular organisms;Bacteria;Firmicutes;Clostridia;Oscillospirales;Ruminococcaceae;Ruminococcus;Multi-affiliation
