observation_name	taxonomic_affiliation
Cluster_1	Bacteria;Proteobacteria;Betaproteobacteria;Burkholderiales;Alcaligenaceae;Alcaligenes;Alcaligenes_faecalis
Cluster_2	Bacteria;Proteobacteria;Gammaproteobacteria;Enterobacterales;Morganellaceae;Xenorhabdus;Xenorhabdus_nematophila
Cluster_3	Bacteria;Proteobacteria;Alphaproteobacteria;Rhizobiales;Brucellaceae;Ochrobactrum;Ochrobactrum_anthropi
Cluster_4	Bacteria;Proteobacteria;Gammaproteobacteria;Xanthomonadales;Xanthomonadaceae;Stenotrophomonas;Stenotrophomonas_maltophilia
Cluster_5	Bacteria;Proteobacteria;Gammaproteobacteria;Pseudomonadales;Pseudomonadaceae;Pseudomonas;Pseudomonas_putida
Cluster_6	Bacteria;Proteobacteria;Gammaproteobacteria;Enterobacterales;Morganellaceae;Photorhabdus;Photorhabdus_luminescens
Cluster_7	Bacteria;Proteobacteria;Gammaproteobacteria;Xanthomonadales;Xanthomonadaceae;Stenotrophomonas;Stenotrophomonas_maltophilia
Cluster_8	Bacteria;Proteobacteria;Alphaproteobacteria;Rhizobiales;Brucellaceae;Pseudochrobactrum;Pseudochrobactrum_sp._AO18b
Cluster_9	Bacteria;Proteobacteria;Betaproteobacteria;Burkholderiales;Alcaligenaceae;Alcaligenes;Alcaligenes_faecalis
Cluster_10	Bacteria;Proteobacteria;Gammaproteobacteria;Pseudomonadales;Pseudomonadaceae;Pseudomonas;Pseudomonas_sp._EGD-AK9
Cluster_11	Bacteria;Firmicutes;Bacilli;Bacillales;Bacillaceae;Bacillus;Multi-affiliation
Cluster_12	Bacteria;Proteobacteria;Alphaproteobacteria;Caulobacterales;Caulobacteraceae;Brevundimonas;Brevundimonas_diminuta
Cluster_13	Bacteria;Proteobacteria;Alphaproteobacteria;Sphingomonadales;Sphingomonadaceae;Sphingomonas;Sphingomonas_koreensis
Cluster_14	Bacteria;Proteobacteria;Alphaproteobacteria;Caulobacterales;Caulobacteraceae;Brevundimonas;Multi-affiliation
Cluster_15	Bacteria;Firmicutes;Bacilli;Bacillales;Paenibacillaceae;Paenibacillus;Paenibacillus_sp._Y412MC10
Cluster_16	Bacteria;Proteobacteria;Alphaproteobacteria;Rhizobiales;Brucellaceae;Ochrobactrum;Ochrobactrum_rhizosphaerae
Cluster_17	Bacteria;Proteobacteria;Gammaproteobacteria;Enterobacterales;Yersiniaceae;Serratia;Serratia_liquefaciens
Cluster_18	Bacteria;Proteobacteria;Gammaproteobacteria;Pseudomonadales;Pseudomonadaceae;Pseudomonas;Pseudomonas_fluorescens
Cluster_19	Bacteria;Proteobacteria;Gammaproteobacteria;Pseudomonadales;Pseudomonadaceae;Pseudomonas;Pseudomonas_putida
Cluster_20	Bacteria;Proteobacteria;Gammaproteobacteria;Pseudomonadales;Pseudomonadaceae;Pseudomonas;Pseudomonas_chlororaphis
Cluster_21	Bacteria;Proteobacteria;Gammaproteobacteria;Pseudomonadales;Pseudomonadaceae;Pseudomonas;Pseudomonas_sp._EGD-AK9
Cluster_22	Bacteria;Proteobacteria;Alphaproteobacteria;Rhizobiales;Brucellaceae;Ochrobactrum;Ochrobactrum_pseudogrignonense
Cluster_23	Bacteria;Proteobacteria;Gammaproteobacteria;Enterobacterales;Yersiniaceae;Serratia;Serratia_sp._JKS296
Cluster_24	Bacteria;Firmicutes;Bacilli;Lactobacillales;Enterococcaceae;Enterococcus;Enterococcus_mundtii
Cluster_25	Bacteria;Proteobacteria;Alphaproteobacteria;Rhizobiales;Brucellaceae;Pseudochrobactrum;Pseudochrobactrum_sp._AO18b
Cluster_26	Bacteria;Proteobacteria;Alphaproteobacteria;Rhizobiales;Bradyrhizobiaceae;Afipia;Afipia_broomeae
Cluster_27	Bacteria;Proteobacteria;Betaproteobacteria;Burkholderiales;Alcaligenaceae;Achromobacter;Achromobacter_sp._DH1f
Cluster_28	Bacteria;Proteobacteria;Gammaproteobacteria;Xanthomonadales;Xanthomonadaceae;Stenotrophomonas;Stenotrophomonas_maltophilia
Cluster_29	Bacteria;Proteobacteria;Alphaproteobacteria;Rhizobiales;Brucellaceae;Ochrobactrum;Multi-affiliation
Cluster_30	Bacteria;Proteobacteria;Gammaproteobacteria;Pseudomonadales;Moraxellaceae;Acinetobacter;Multi-affiliation
Cluster_31	Bacteria;Proteobacteria;Gammaproteobacteria;Pseudomonadales;Pseudomonadaceae;Pseudomonas;Multi-affiliation
Cluster_32	Bacteria;Bacteroidetes;Flavobacteriia;Flavobacteriales;Flavobacteriaceae;Flavobacterium;Flavobacterium_sp._Leaf359
Cluster_33	Bacteria;Proteobacteria;Gammaproteobacteria;Pseudomonadales;Moraxellaceae;Acinetobacter;Acinetobacter_sp._NIPH_1867
Cluster_34	Bacteria;Firmicutes;Bacilli;Bacillales;Thermoactinomycetaceae;Planifilum;Planifilum_fimeticola
Cluster_35	Bacteria;Proteobacteria;Alphaproteobacteria;Rhizobiales;Phyllobacteriaceae;Aminobacter;Aminobacter_aminovorans
Cluster_36	Bacteria;Proteobacteria;Gammaproteobacteria;Xanthomonadales;Xanthomonadaceae;Stenotrophomonas;Stenotrophomonas_maltophilia
Cluster_37	Bacteria;Proteobacteria;Alphaproteobacteria;Rhizobiales;Brucellaceae;Pseudochrobactrum;Pseudochrobactrum_sp._AO18b
Cluster_38	Bacteria;Proteobacteria;Alphaproteobacteria;Caulobacterales;Caulobacteraceae;Brevundimonas;Multi-affiliation
Cluster_39	Bacteria;Proteobacteria;Gammaproteobacteria;Enterobacterales;Morganellaceae;Xenorhabdus;Xenorhabdus_bovienii
Cluster_40	Bacteria;Proteobacteria;Gammaproteobacteria;Pseudomonadales;Pseudomonadaceae;Pseudomonas;Pseudomonas_sp._PH1b
Cluster_41	Bacteria;Proteobacteria;Alphaproteobacteria;Rhizobiales;Rhizobiaceae;Sinorhizobium;Sinorhizobium_sp._RAC02
Cluster_42	Bacteria;Proteobacteria;Gammaproteobacteria;Cellvibrionales;Cellvibrionaceae;Cellvibrio;Cellvibrio_sp._pealriver
Cluster_43	Bacteria;Proteobacteria;Betaproteobacteria;Burkholderiales;Alcaligenaceae;Alcaligenes;Alcaligenes_faecalis
Cluster_44	Bacteria;Firmicutes;Bacilli;Bacillales;Thermoactinomycetaceae;Planifilum;Planifilum_fulgidum
Cluster_45	Bacteria;Proteobacteria;Gammaproteobacteria;Enterobacterales;Enterobacteriaceae;Citrobacter;Citrobacter_sp._MGH100
Cluster_46	Bacteria;Proteobacteria;Betaproteobacteria;Burkholderiales;Comamonadaceae;Delftia;Multi-affiliation
Cluster_47	Bacteria;Firmicutes;Bacilli;Bacillales;Bacillaceae;Lysinibacillus;Lysinibacillus_sphaericus
Cluster_48	Bacteria;Proteobacteria;Gammaproteobacteria;Xanthomonadales;Xanthomonadaceae;Stenotrophomonas;Stenotrophomonas_rhizophila
Cluster_49	Bacteria;Proteobacteria;Alphaproteobacteria;Rhizobiales;Hyphomicrobiaceae;Devosia;Devosia_psychrophila
Cluster_50	Bacteria;Proteobacteria;Betaproteobacteria;Burkholderiales;Alcaligenaceae;Achromobacter;Multi-affiliation
Cluster_51	Bacteria;Proteobacteria;Alphaproteobacteria;Rhizobiales;Rhizobiaceae;Sinorhizobium;Sinorhizobium_sp._RAC02
Cluster_52	Bacteria;Proteobacteria;Betaproteobacteria;Burkholderiales;Alcaligenaceae;Achromobacter;Achromobacter_sp._2789STDY5608607
Cluster_53	Bacteria;Proteobacteria;Gammaproteobacteria;Xanthomonadales;Xanthomonadaceae;Stenotrophomonas;Stenotrophomonas_humi
Cluster_54	Bacteria;Proteobacteria;Alphaproteobacteria;Rhizobiales;Bradyrhizobiaceae;Afipia;Afipia_birgiae
Cluster_55	Bacteria;Firmicutes;Bacilli;Bacillales;Paenibacillaceae;Paenibacillus;Paenibacillus_sp._DMB5
Cluster_56	Bacteria;Proteobacteria;Gammaproteobacteria;Xanthomonadales;Xanthomonadaceae;Stenotrophomonas;Stenotrophomonas_maltophilia
Cluster_57	Bacteria;Proteobacteria;Gammaproteobacteria;Pseudomonadales;Pseudomonadaceae;Pseudomonas;Pseudomonas_brenneri
Cluster_58	Bacteria;Proteobacteria;Gammaproteobacteria;Pseudomonadales;Pseudomonadaceae;Pseudomonas;Multi-affiliation
Cluster_59	Bacteria;Proteobacteria;Betaproteobacteria;Burkholderiales;Comamonadaceae;Delftia;Multi-affiliation
Cluster_60	Bacteria;Proteobacteria;Betaproteobacteria;Burkholderiales;Comamonadaceae;Pelomonas;Pelomonas_sp._Root1444
Cluster_61	Bacteria;Proteobacteria;Alphaproteobacteria;Rhizobiales;Brucellaceae;Pseudochrobactrum;Pseudochrobactrum_sp._AO18b
Cluster_62	Bacteria;Bacteroidetes;Sphingobacteriia;Sphingobacteriales;Sphingobacteriaceae;Sphingobacterium;Sphingobacterium_multivorum
Cluster_63	Bacteria;Proteobacteria;Betaproteobacteria;Burkholderiales;Comamonadaceae;Variovorax;Variovorax_sp._Root473
Cluster_64	Bacteria;Proteobacteria;Betaproteobacteria;Burkholderiales;unclassified;unclassified;Multi-affiliation
Cluster_65	Bacteria;Proteobacteria;Alphaproteobacteria;Caulobacterales;Caulobacteraceae;Brevundimonas;Brevundimonas_diminuta
Cluster_66	Bacteria;Proteobacteria;Alphaproteobacteria;Rhizobiales;Brucellaceae;Pseudochrobactrum;Pseudochrobactrum_sp._AO18b
Cluster_67	Bacteria;Bacteroidetes;Chitinophagia;Chitinophagales;Chitinophagaceae;Filimonas;Filimonas_lacunae
Cluster_68	Bacteria;Proteobacteria;Betaproteobacteria;Burkholderiales;Comamonadaceae;Acidovorax;Multi-affiliation
Cluster_69	Bacteria;Proteobacteria;Gammaproteobacteria;Enterobacterales;Enterobacteriaceae;Multi-affiliation;Multi-affiliation
Cluster_70	Bacteria;Proteobacteria;Alphaproteobacteria;Rhizobiales;Hyphomicrobiaceae;Devosia;Devosia_psychrophila
Cluster_71	Bacteria;Proteobacteria;Alphaproteobacteria;Rhizobiales;Bradyrhizobiaceae;Afipia;Multi-affiliation
Cluster_72	Bacteria;Proteobacteria;Gammaproteobacteria;Xanthomonadales;Xanthomonadaceae;Stenotrophomonas;Stenotrophomonas_humi
Cluster_73	Bacteria;Proteobacteria;Alphaproteobacteria;Rhizobiales;Brucellaceae;Ochrobactrum;Ochrobactrum_rhizosphaerae
Cluster_74	Bacteria;Proteobacteria;Alphaproteobacteria;Caulobacterales;Caulobacteraceae;Brevundimonas;Brevundimonas_sp._Root1279
Cluster_75	Bacteria;Proteobacteria;Alphaproteobacteria;Caulobacterales;Caulobacteraceae;Brevundimonas;Brevundimonas_sp._Root1279
Cluster_76	Bacteria;Proteobacteria;Alphaproteobacteria;Rhizobiales;Rhizobiaceae;Multi-affiliation;Multi-affiliation
Cluster_78	Bacteria;Proteobacteria;Alphaproteobacteria;Rhizobiales;Phyllobacteriaceae;Mesorhizobium;Multi-affiliation
Cluster_79	Bacteria;Proteobacteria;Alphaproteobacteria;Caulobacterales;Caulobacteraceae;Brevundimonas;Brevundimonas_sp._BAL3
Cluster_80	Bacteria;Proteobacteria;Gammaproteobacteria;Xanthomonadales;Xanthomonadaceae;Stenotrophomonas;Stenotrophomonas_maltophilia
Cluster_81	Bacteria;Proteobacteria;Alphaproteobacteria;Rhizobiales;Hyphomicrobiaceae;Devosia;Devosia_sp._Root413D1
Cluster_82	Bacteria;Proteobacteria;Alphaproteobacteria;Rhizobiales;Brucellaceae;Ochrobactrum;Ochrobactrum_rhizosphaerae
Cluster_83	Bacteria;Proteobacteria;Alphaproteobacteria;Rhizobiales;Hyphomicrobiaceae;Hyphomicrobium;Multi-affiliation
Cluster_84	Bacteria;Proteobacteria;Betaproteobacteria;Burkholderiales;Oxalobacteraceae;Janthinobacterium;Multi-affiliation
Cluster_85	Bacteria;Proteobacteria;Alphaproteobacteria;Sphingomonadales;Sphingomonadaceae;Sphingopyxis;Sphingopyxis_ummariensis
Cluster_86	Bacteria;Proteobacteria;Betaproteobacteria;Burkholderiales;Comamonadaceae;Variovorax;Variovorax_paradoxus
Cluster_87	Bacteria;Proteobacteria;Gammaproteobacteria;Xanthomonadales;Xanthomonadaceae;Stenotrophomonas;Stenotrophomonas_humi
Cluster_88	Bacteria;Proteobacteria;Gammaproteobacteria;Xanthomonadales;Nevskiaceae;Nevskia;Nevskia_soli
Cluster_89	Bacteria;Proteobacteria;Betaproteobacteria;Burkholderiales;Comamonadaceae;Variovorax;Variovorax_boronicumulans
Cluster_90	Bacteria;Proteobacteria;Betaproteobacteria;Burkholderiales;Comamonadaceae;Variovorax;unclassified
Cluster_91	Bacteria;Proteobacteria;Betaproteobacteria;Burkholderiales;Alcaligenaceae;Achromobacter;Achromobacter_xylosoxidans
Cluster_92	Bacteria;Proteobacteria;Alphaproteobacteria;Rhizobiales;Hyphomicrobiaceae;Devosia;Multi-affiliation
Cluster_93	Bacteria;Bacteroidetes;Sphingobacteriia;Sphingobacteriales;Sphingobacteriaceae;Sphingobacterium;Sphingobacterium_multivorum
Cluster_94	Bacteria;Proteobacteria;Alphaproteobacteria;Rhizobiales;Phyllobacteriaceae;Phyllobacterium;Phyllobacterium_sp._YR531
Cluster_95	Bacteria;Proteobacteria;Alphaproteobacteria;Rhizobiales;Brucellaceae;Ochrobactrum;Multi-affiliation
Cluster_96	Bacteria;Proteobacteria;Gammaproteobacteria;Xanthomonadales;Xanthomonadaceae;Stenotrophomonas;Multi-affiliation
Cluster_97	Bacteria;Proteobacteria;Alphaproteobacteria;Rhizobiales;Brucellaceae;Pseudochrobactrum;Pseudochrobactrum_sp._AO18b
Cluster_98	Bacteria;Firmicutes;Bacilli;Lactobacillales;Enterococcaceae;Enterococcus;Enterococcus_mundtii
Cluster_99	Bacteria;Proteobacteria;Betaproteobacteria;Burkholderiales;Comamonadaceae;Acidovorax;Acidovorax_sp._KKS102
Cluster_100	Bacteria;Proteobacteria;Alphaproteobacteria;Caulobacterales;Caulobacteraceae;Phenylobacterium;Phenylobacterium_sp._Root700
Cluster_101	Bacteria;Proteobacteria;Alphaproteobacteria;Rhizobiales;Rhizobiaceae;Multi-affiliation;Multi-affiliation
Cluster_102	Bacteria;Proteobacteria;Alphaproteobacteria;Rhizobiales;Hyphomicrobiaceae;Devosia;Devosia_sp._Root105
Cluster_103	Bacteria;Proteobacteria;Alphaproteobacteria;Rhizobiales;Bradyrhizobiaceae;Afipia;Afipia_massiliensis
Cluster_104	Bacteria;Proteobacteria;Gammaproteobacteria;Pseudomonadales;Moraxellaceae;Acinetobacter;Acinetobacter_rudis
Cluster_105	Bacteria;Proteobacteria;Betaproteobacteria;Burkholderiales;Burkholderiaceae;Cupriavidus;Cupriavidus_metallidurans
Cluster_106	Bacteria;Proteobacteria;Alphaproteobacteria;Rhizobiales;Brucellaceae;Ochrobactrum;Ochrobactrum_rhizosphaerae
Cluster_107	Bacteria;Proteobacteria;Gammaproteobacteria;Pseudomonadales;Pseudomonadaceae;Pseudomonas;Pseudomonas_putida
Cluster_108	Bacteria;Proteobacteria;Alphaproteobacteria;Rhizobiales;Rhizobiaceae;Multi-affiliation;Multi-affiliation
Cluster_109	Bacteria;Proteobacteria;Betaproteobacteria;Burkholderiales;Comamonadaceae;Acidovorax;Acidovorax_sp._GW101-3H11
Cluster_110	Bacteria;Proteobacteria;Alphaproteobacteria;Sphingomonadales;Sphingomonadaceae;Sphingopyxis;Sphingopyxis_sp._RIFCSPHIGHO2_12_FULL_65_19
Cluster_111	Bacteria;Proteobacteria;Gammaproteobacteria;Legionellales;Coxiellaceae;unclassified;unclassified
Cluster_112	Bacteria;Proteobacteria;Alphaproteobacteria;Rhizobiales;Brucellaceae;Pseudochrobactrum;Pseudochrobactrum_sp._AO18b
Cluster_113	Bacteria;Proteobacteria;Alphaproteobacteria;Caulobacterales;Caulobacteraceae;Brevundimonas;Brevundimonas_sp._Root1279
Cluster_114	Bacteria;Proteobacteria;Betaproteobacteria;Burkholderiales;Alcaligenaceae;Achromobacter;Achromobacter_xylosoxidans
Cluster_115	Bacteria;Proteobacteria;Alphaproteobacteria;Rhizobiales;Hyphomicrobiaceae;Devosia;Devosia_sp._LC5
Cluster_116	Bacteria;Proteobacteria;Betaproteobacteria;Burkholderiales;unclassified;unclassified;Multi-affiliation
Cluster_117	Bacteria;Proteobacteria;Betaproteobacteria;Burkholderiales;Comamonadaceae;Variovorax;Multi-affiliation
Cluster_118	Bacteria;Proteobacteria;Alphaproteobacteria;Rhizobiales;Phyllobacteriaceae;Phyllobacterium;Phyllobacterium_sp._OV277
Cluster_119	Bacteria;Proteobacteria;Alphaproteobacteria;Rhizobiales;Brucellaceae;Ochrobactrum;Multi-affiliation
Cluster_120	Bacteria;Proteobacteria;Gammaproteobacteria;Pseudomonadales;Pseudomonadaceae;Pseudomonas;Multi-affiliation
Cluster_121	Bacteria;Bacteroidetes;Flavobacteriia;Flavobacteriales;Flavobacteriaceae;Flavobacterium;Flavobacterium_sp._URHB0058
Cluster_122	Bacteria;Proteobacteria;Alphaproteobacteria;Rhizobiales;Phyllobacteriaceae;Mesorhizobium;Mesorhizobium_sp._ORS3359
Cluster_124	Bacteria;Proteobacteria;Alphaproteobacteria;Sphingomonadales;Sphingomonadaceae;Sphingopyxis;Multi-affiliation
Cluster_126	Bacteria;Proteobacteria;Alphaproteobacteria;Sphingomonadales;Sphingomonadaceae;Sphingomonas;Sphingomonas_koreensis
Cluster_127	Bacteria;Bacteroidetes;Sphingobacteriia;Sphingobacteriales;Sphingobacteriaceae;Sphingobacterium;Multi-affiliation
Cluster_128	Bacteria;Proteobacteria;Alphaproteobacteria;Sphingomonadales;Sphingomonadaceae;Sphingopyxis;Multi-affiliation
Cluster_129	Bacteria;Proteobacteria;Gammaproteobacteria;Enterobacterales;Morganellaceae;Photorhabdus;Photorhabdus_luminescens
Cluster_130	Bacteria;Proteobacteria;Gammaproteobacteria;Pseudomonadales;Pseudomonadaceae;Pseudomonas;Pseudomonas_putida
Cluster_131	Bacteria;Proteobacteria;Alphaproteobacteria;Rhizobiales;Rhizobiaceae;Sinorhizobium;Sinorhizobium_sp._RAC02
Cluster_132	Bacteria;Bacteroidetes;Flavobacteriia;Flavobacteriales;Flavobacteriaceae;Flavobacterium;Flavobacterium_sp._Leaf359
Cluster_133	Bacteria;Proteobacteria;Betaproteobacteria;Burkholderiales;Alcaligenaceae;Achromobacter;Achromobacter_xylosoxidans
Cluster_134	Bacteria;Proteobacteria;Alphaproteobacteria;Sphingomonadales;Sphingomonadaceae;Sphingopyxis;Multi-affiliation
Cluster_135	Bacteria;Proteobacteria;Betaproteobacteria;Burkholderiales;Alcaligenaceae;Achromobacter;Achromobacter_piechaudii
Cluster_136	Bacteria;Proteobacteria;Alphaproteobacteria;Rhizobiales;Hyphomicrobiaceae;Devosia;Devosia_psychrophila
Cluster_137	Bacteria;Proteobacteria;Alphaproteobacteria;Rhizobiales;Bradyrhizobiaceae;Afipia;Afipia_broomeae
Cluster_138	Bacteria;Proteobacteria;Gammaproteobacteria;Pseudomonadales;Pseudomonadaceae;Pseudomonas;Multi-affiliation
Cluster_139	Bacteria;Proteobacteria;Betaproteobacteria;Burkholderiales;Comamonadaceae;Acidovorax;Multi-affiliation
Cluster_140	Bacteria;Proteobacteria;Alphaproteobacteria;Caulobacterales;Caulobacteraceae;Phenylobacterium;Multi-affiliation
Cluster_141	Bacteria;Proteobacteria;Betaproteobacteria;Burkholderiales;Alcaligenaceae;Achromobacter;Achromobacter_xylosoxidans
Cluster_143	Bacteria;Proteobacteria;Gammaproteobacteria;Xanthomonadales;Xanthomonadaceae;Stenotrophomonas;Multi-affiliation
Cluster_144	Bacteria;Proteobacteria;Gammaproteobacteria;Pseudomonadales;Pseudomonadaceae;Pseudomonas;Pseudomonas_azotoformans
Cluster_145	Bacteria;Proteobacteria;Gammaproteobacteria;Xanthomonadales;Xanthomonadaceae;Stenotrophomonas;Stenotrophomonas_sp._KCTC_12332
Cluster_146	Bacteria;Proteobacteria;Gammaproteobacteria;Pasteurellales;Pasteurellaceae;Haemophilus;Haemophilus_influenzae
Cluster_147	Bacteria;Proteobacteria;Gammaproteobacteria;Enterobacterales;Enterobacteriaceae;Enterobacter;Multi-affiliation
Cluster_148	Bacteria;Bacteroidetes;Chitinophagia;Chitinophagales;Chitinophagaceae;Flavihumibacter;Flavihumibacter_solisilvae
Cluster_149	Bacteria;Proteobacteria;Gammaproteobacteria;Enterobacterales;Enterobacteriaceae;Lelliottia;Lelliottia_amnigena
Cluster_150	Bacteria;Proteobacteria;Alphaproteobacteria;Rhizobiales;Phyllobacteriaceae;Phyllobacterium;Phyllobacterium_sp._YR531
Cluster_151	Bacteria;Proteobacteria;Alphaproteobacteria;Caulobacterales;Caulobacteraceae;Phenylobacterium;Phenylobacterium_sp._Root700
Cluster_152	Bacteria;Proteobacteria;Gammaproteobacteria;Pseudomonadales;Pseudomonadaceae;Pseudomonas;Multi-affiliation
Cluster_153	Bacteria;Proteobacteria;Alphaproteobacteria;Sphingomonadales;Sphingomonadaceae;Sphingomonas;Sphingomonas_koreensis
Cluster_154	Bacteria;Bacteroidetes;Sphingobacteriia;Sphingobacteriales;Sphingobacteriaceae;Pedobacter;Pedobacter_sp._PACM_27299
Cluster_155	Bacteria;Proteobacteria;Alphaproteobacteria;Rhodobacterales;Rhodobacteraceae;Paracoccus;Paracoccus_aminophilus
Cluster_156	Bacteria;Proteobacteria;Betaproteobacteria;Burkholderiales;Comamonadaceae;Variovorax;unclassified
Cluster_157	Bacteria;Proteobacteria;Alphaproteobacteria;Rhizobiales;Phyllobacteriaceae;Mesorhizobium;Mesorhizobium_loti
Cluster_158	Bacteria;Proteobacteria;Alphaproteobacteria;Rhizobiales;Rhizobiaceae;Sinorhizobium;Sinorhizobium_sp._RAC02
Cluster_159	Bacteria;Proteobacteria;Betaproteobacteria;Burkholderiales;Oxalobacteraceae;Janthinobacterium;Janthinobacterium_sp._Marseille
Cluster_160	Bacteria;Proteobacteria;Alphaproteobacteria;Rhizobiales;Rhizobiaceae;Neorhizobium;Neorhizobium_galegae
Cluster_162	Bacteria;Proteobacteria;Betaproteobacteria;Burkholderiales;Alcaligenaceae;Achromobacter;Achromobacter_sp._DH1f
Cluster_163	Bacteria;Proteobacteria;Alphaproteobacteria;Rhizobiales;Rhizobiaceae;Shinella;Shinella_sp._DD12
Cluster_164	Bacteria;Firmicutes;Bacilli;Lactobacillales;Multi-affiliation;Multi-affiliation;Multi-affiliation
Cluster_165	Bacteria;Proteobacteria;Alphaproteobacteria;Rhodobacterales;Rhodobacteraceae;Nereida;Nereida_ignava
Cluster_167	Bacteria;Proteobacteria;Alphaproteobacteria;Sphingomonadales;Sphingomonadaceae;Sphingopyxis;Sphingopyxis_sp._RIFCSPHIGHO2_01_FULL_65_24
Cluster_168	Bacteria;Proteobacteria;Gammaproteobacteria;Enterobacterales;Morganellaceae;Xenorhabdus;Xenorhabdus_nematophila
Cluster_169	Bacteria;Proteobacteria;Alphaproteobacteria;Rhizobiales;Phyllobacteriaceae;Aminobacter;Aminobacter_aminovorans
Cluster_170	Bacteria;Proteobacteria;Alphaproteobacteria;Rhizobiales;Brucellaceae;Ochrobactrum;Ochrobactrum_rhizosphaerae
Cluster_171	Bacteria;Proteobacteria;Betaproteobacteria;Burkholderiales;Alcaligenaceae;Achromobacter;Achromobacter_sp._DH1f
Cluster_172	Bacteria;Proteobacteria;Alphaproteobacteria;Rhizobiales;Bradyrhizobiaceae;unclassified;Bradyrhizobiaceae_bacterium_SG-6C
Cluster_173	Bacteria;Proteobacteria;Alphaproteobacteria;Rhizobiales;Hyphomicrobiaceae;Devosia;Devosia_limi
Cluster_174	Bacteria;Proteobacteria;Alphaproteobacteria;Sphingomonadales;Sphingomonadaceae;Sphingopyxis;Sphingopyxis_sp._YR583
Cluster_176	Bacteria;Proteobacteria;Alphaproteobacteria;Rhizobiales;Rhizobiaceae;Ensifer;Multi-affiliation
Cluster_177	Bacteria;Proteobacteria;Gammaproteobacteria;Pseudomonadales;Pseudomonadaceae;Pseudomonas;Pseudomonas_putida
Cluster_178	Bacteria;Proteobacteria;Betaproteobacteria;Burkholderiales;Alcaligenaceae;Bordetella;Bordetella_avium
Cluster_180	Bacteria;Proteobacteria;Betaproteobacteria;Burkholderiales;Alcaligenaceae;Achromobacter;Achromobacter_sp._DH1f
Cluster_181	Bacteria;Proteobacteria;Gammaproteobacteria;Xanthomonadales;Xanthomonadaceae;Stenotrophomonas;Stenotrophomonas_maltophilia
Cluster_183	Bacteria;Bacteroidetes;Flavobacteriia;Flavobacteriales;Flavobacteriaceae;Chryseobacterium;Multi-affiliation
Cluster_185	Bacteria;Proteobacteria;Alphaproteobacteria;Sphingomonadales;Sphingomonadaceae;Sphingopyxis;Sphingopyxis_sp._MWB1
Cluster_186	Bacteria;Bacteroidetes;Sphingobacteriia;Sphingobacteriales;Sphingobacteriaceae;Sphingobacterium;Sphingobacterium_sp._ML3W
Cluster_187	Bacteria;Proteobacteria;Betaproteobacteria;Burkholderiales;Comamonadaceae;Delftia;Multi-affiliation
Cluster_188	Bacteria;Bacteroidetes;Flavobacteriia;Flavobacteriales;Flavobacteriaceae;Flavobacterium;Flavobacterium_sp._VMW
Cluster_190	Bacteria;Proteobacteria;Alphaproteobacteria;Rhizobiales;Brucellaceae;Pseudochrobactrum;Pseudochrobactrum_sp._AO18b
Cluster_191	Bacteria;Proteobacteria;Alphaproteobacteria;unclassified;unclassified;unclassified;unclassified
Cluster_192	Bacteria;Proteobacteria;Alphaproteobacteria;Sphingomonadales;Sphingomonadaceae;Sphingopyxis;Multi-affiliation
Cluster_194	Bacteria;Proteobacteria;Alphaproteobacteria;Caulobacterales;Caulobacteraceae;Brevundimonas;Brevundimonas_diminuta
Cluster_195	Bacteria;Proteobacteria;Betaproteobacteria;Burkholderiales;Alcaligenaceae;Achromobacter;Achromobacter_spanius
Cluster_196	Bacteria;Proteobacteria;Alphaproteobacteria;Rhizobiales;Rhizobiaceae;Sinorhizobium;Sinorhizobium_sp._RAC02
Cluster_197	Bacteria;Firmicutes;Bacilli;Bacillales;Paenibacillaceae;Paenibacillus;Paenibacillus_sp._FSL_H7-0737
Cluster_198	Bacteria;Proteobacteria;Gammaproteobacteria;Pseudomonadales;Pseudomonadaceae;Pseudomonas;Pseudomonas_chlororaphis
Cluster_199	Bacteria;Proteobacteria;Gammaproteobacteria;Enterobacterales;Yersiniaceae;Serratia;Serratia_sp._TEL
Cluster_200	Bacteria;Proteobacteria;Multi-affiliation;Multi-affiliation;Multi-affiliation;Multi-affiliation;Multi-affiliation
Cluster_201	Bacteria;Proteobacteria;Alphaproteobacteria;Sphingomonadales;Sphingomonadaceae;Sphingopyxis;Sphingopyxis_macrogoltabida
Cluster_202	Bacteria;Proteobacteria;Gammaproteobacteria;Xanthomonadales;Xanthomonadaceae;Stenotrophomonas;Multi-affiliation
Cluster_203	Bacteria;Proteobacteria;Alphaproteobacteria;Sphingomonadales;Sphingomonadaceae;Sphingopyxis;Sphingopyxis_sp._LC81
Cluster_204	Bacteria;Proteobacteria;Alphaproteobacteria;Caulobacterales;Caulobacteraceae;Phenylobacterium;Multi-affiliation
Cluster_205	Bacteria;Proteobacteria;Betaproteobacteria;Burkholderiales;Alcaligenaceae;Achromobacter;Multi-affiliation
Cluster_207	Bacteria;Proteobacteria;Alphaproteobacteria;Rhizobiales;Phyllobacteriaceae;Mesorhizobium;Multi-affiliation
Cluster_208	Bacteria;Proteobacteria;Alphaproteobacteria;Rhizobiales;Rhizobiaceae;Shinella;Shinella_sp._DD12
Cluster_209	Bacteria;Bacteroidetes;Flavobacteriia;Flavobacteriales;Flavobacteriaceae;Flavobacterium;Flavobacterium_ummariense
Cluster_210	Bacteria;Proteobacteria;Alphaproteobacteria;Rhizobiales;Bradyrhizobiaceae;Afipia;Afipia_broomeae
Cluster_211	Bacteria;Bacteroidetes;Flavobacteriia;Flavobacteriales;Flavobacteriaceae;Flavobacterium;Flavobacterium_sp._Leaf359
Cluster_212	Bacteria;Proteobacteria;Betaproteobacteria;Burkholderiales;Oxalobacteraceae;Collimonas;unclassified
Cluster_213	Bacteria;Proteobacteria;Gammaproteobacteria;Enterobacterales;Morganellaceae;Photorhabdus;Photorhabdus_luminescens
Cluster_214	Bacteria;Proteobacteria;Betaproteobacteria;Burkholderiales;Comamonadaceae;Variovorax;Variovorax_sp._PDC80
Cluster_215	Bacteria;Bacteroidetes;Sphingobacteriia;Sphingobacteriales;Sphingobacteriaceae;Sphingobacterium;Sphingobacterium_faecium
Cluster_216	Bacteria;Proteobacteria;Alphaproteobacteria;Rhizobiales;Rhizobiaceae;Ensifer;Ensifer_adhaerens
Cluster_217	Bacteria;Proteobacteria;Alphaproteobacteria;Rhizobiales;Bradyrhizobiaceae;Afipia;Afipia_broomeae
Cluster_218	Bacteria;Proteobacteria;Alphaproteobacteria;Caulobacterales;Caulobacteraceae;Brevundimonas;Brevundimonas_sp._Root1279
Cluster_219	Bacteria;Proteobacteria;Betaproteobacteria;Burkholderiales;unclassified;Rhizobacter;Multi-affiliation
Cluster_220	Bacteria;Proteobacteria;Gammaproteobacteria;Pseudomonadales;Pseudomonadaceae;Pseudomonas;Multi-affiliation
Cluster_221	Bacteria;Proteobacteria;Betaproteobacteria;Burkholderiales;Alcaligenaceae;Achromobacter;Achromobacter_piechaudii
Cluster_222	Bacteria;Proteobacteria;Gammaproteobacteria;Pseudomonadales;Pseudomonadaceae;Pseudomonas;Pseudomonas_brenneri
Cluster_224	Bacteria;Proteobacteria;Betaproteobacteria;Nitrosomonadales;Methylophilaceae;Methylobacillus;Methylobacillus_glycogenes
Cluster_225	Bacteria;Proteobacteria;Alphaproteobacteria;Caulobacterales;unclassified;unclassified;Caulobacterales_bacterium_RIFOXYB1_FULL_67_16
Cluster_226	Bacteria;Proteobacteria;Alphaproteobacteria;Caulobacterales;Caulobacteraceae;Brevundimonas;Multi-affiliation
Cluster_228	Bacteria;Bacteroidetes;Sphingobacteriia;Sphingobacteriales;Sphingobacteriaceae;Pedobacter;Pedobacter_sp.
Cluster_229	Bacteria;Bacteroidetes;Sphingobacteriia;Sphingobacteriales;Sphingobacteriaceae;Pedobacter;Pedobacter_antarcticus
Cluster_230	Bacteria;Proteobacteria;Alphaproteobacteria;Sphingomonadales;Sphingomonadaceae;Sphingomonas;Sphingomonas_hengshuiensis
Cluster_231	Bacteria;Proteobacteria;Gammaproteobacteria;Pseudomonadales;Pseudomonadaceae;Pseudomonas;Multi-affiliation
Cluster_232	Bacteria;Proteobacteria;Betaproteobacteria;Burkholderiales;Burkholderiaceae;Cupriavidus;Cupriavidus_basilensis
Cluster_233	Bacteria;Proteobacteria;Alphaproteobacteria;Sphingomonadales;Sphingomonadaceae;Sphingomonas;Sphingomonas_koreensis
Cluster_236	Bacteria;Proteobacteria;Gammaproteobacteria;Nevskiales;Sinobacteraceae;Solimonas;Solimonas_variicoloris
Cluster_237	Bacteria;Proteobacteria;Alphaproteobacteria;Rhizobiales;Bradyrhizobiaceae;Bradyrhizobium;Bradyrhizobium_sp._CCBAU_43298
Cluster_238	Bacteria;Proteobacteria;Betaproteobacteria;Burkholderiales;Alcaligenaceae;Achromobacter;Achromobacter_sp._DMS1
Cluster_240	Bacteria;Proteobacteria;Betaproteobacteria;Burkholderiales;Alcaligenaceae;Alcaligenes;Alcaligenes_faecalis
Cluster_241	Bacteria;Bacteroidetes;Sphingobacteriia;Sphingobacteriales;Sphingobacteriaceae;Pedobacter;Pedobacter_sp._Hv1
Cluster_242	Bacteria;Proteobacteria;Betaproteobacteria;Burkholderiales;Alcaligenaceae;Achromobacter;Multi-affiliation
Cluster_243	Bacteria;Proteobacteria;Gammaproteobacteria;Enterobacterales;Morganellaceae;Xenorhabdus;Xenorhabdus_nematophila
Cluster_244	Bacteria;Proteobacteria;Alphaproteobacteria;Caulobacterales;Caulobacteraceae;Brevundimonas;Brevundimonas_sp._Root1279
Cluster_245	Bacteria;Proteobacteria;Gammaproteobacteria;Pseudomonadales;Pseudomonadaceae;Pseudomonas;Pseudomonas_sp._DRA525
Cluster_246	Bacteria;Proteobacteria;Gammaproteobacteria;Pseudomonadales;Pseudomonadaceae;Pseudomonas;Multi-affiliation
Cluster_248	Bacteria;Proteobacteria;Gammaproteobacteria;Pseudomonadales;Pseudomonadaceae;Pseudomonas;Pseudomonas_sp._PH1b
Cluster_250	Bacteria;Bacteroidetes;Sphingobacteriia;Sphingobacteriales;Sphingobacteriaceae;Sphingobacterium;Multi-affiliation
Cluster_251	Bacteria;Proteobacteria;Gammaproteobacteria;Enterobacterales;Enterobacteriaceae;Enterobacter;Enterobacter_cancerogenus
Cluster_255	Bacteria;Proteobacteria;Gammaproteobacteria;Pseudomonadales;Pseudomonadaceae;Pseudomonas;Pseudomonas_sp._EGD-AK9
Cluster_256	Bacteria;Actinobacteria;Actinobacteria;Micrococcales;Microbacteriaceae;Microbacterium;Microbacterium_barkeri
Cluster_257	Bacteria;Proteobacteria;Alphaproteobacteria;Rhizobiales;Hyphomicrobiaceae;Devosia;Devosia_sp._17-2-E-8
Cluster_259	Bacteria;Proteobacteria;Alphaproteobacteria;Rhizobiales;Rhizobiaceae;Rhizobium;Rhizobium_sp._Root483D2
Cluster_260	Bacteria;Proteobacteria;Alphaproteobacteria;Rhizobiales;Hyphomicrobiaceae;Devosia;Devosia_riboflavina
Cluster_261	Bacteria;Proteobacteria;Gammaproteobacteria;Nevskiales;Sinobacteraceae;Hydrocarboniphaga;Hydrocarboniphaga_effusa
Cluster_262	Bacteria;Proteobacteria;Gammaproteobacteria;Enterobacterales;Morganellaceae;Xenorhabdus;Xenorhabdus_poinarii
Cluster_265	Bacteria;Proteobacteria;Alphaproteobacteria;Rhizobiales;Rhizobiaceae;Rhizobium;Rhizobium_sp._RU36D
Cluster_266	Bacteria;Proteobacteria;Alphaproteobacteria;Rhizobiales;Rhizobiaceae;Rhizobium;Rhizobium_sp._NFACC06-2
Cluster_267	Bacteria;Bacteroidetes;Sphingobacteriia;Sphingobacteriales;Sphingobacteriaceae;Pedobacter;Pedobacter_sp.
Cluster_268	Bacteria;Proteobacteria;Gammaproteobacteria;Pseudomonadales;Pseudomonadaceae;Pseudomonas;Pseudomonas_fluorescens
Cluster_269	Bacteria;Proteobacteria;Betaproteobacteria;Nitrosomonadales;Methylophilaceae;Methylophilus;Multi-affiliation
Cluster_271	Bacteria;Proteobacteria;Alphaproteobacteria;Rhizobiales;Bradyrhizobiaceae;Bradyrhizobium;Bradyrhizobium_erythrophlei
Cluster_272	Bacteria;Proteobacteria;Alphaproteobacteria;Rhizobiales;Hyphomicrobiaceae;Hyphomicrobium;Hyphomicrobium_nitrativorans
Cluster_273	Bacteria;Proteobacteria;Alphaproteobacteria;Sphingomonadales;Sphingomonadaceae;Sphingopyxis;Multi-affiliation
Cluster_274	Bacteria;Proteobacteria;Betaproteobacteria;Burkholderiales;Alcaligenaceae;Achromobacter;Achromobacter_sp._DH1f
Cluster_275	Bacteria;Proteobacteria;Alphaproteobacteria;Rhizobiales;Hyphomicrobiaceae;Devosia;Devosia_enhydra
Cluster_276	Bacteria;Proteobacteria;Alphaproteobacteria;Caulobacterales;Caulobacteraceae;Caulobacter;Multi-affiliation
Cluster_277	Bacteria;Proteobacteria;Alphaproteobacteria;Caulobacterales;Caulobacteraceae;Brevundimonas;Brevundimonas_diminuta
Cluster_279	Bacteria;Proteobacteria;Alphaproteobacteria;Rhizobiales;Phyllobacteriaceae;Mesorhizobium;Multi-affiliation
Cluster_281	Bacteria;Proteobacteria;Betaproteobacteria;Burkholderiales;Alcaligenaceae;Achromobacter;Achromobacter_sp._DH1f
Cluster_282	Bacteria;Proteobacteria;Gammaproteobacteria;Legionellales;Coxiellaceae;Candidatus_Berkiella;Candidatus_Berkiella_aquae
Cluster_283	Bacteria;Proteobacteria;Alphaproteobacteria;Rhizobiales;Rhizobiaceae;Shinella;Shinella_sp._DD12
Cluster_284	Bacteria;Proteobacteria;Alphaproteobacteria;Rhizobiales;Phyllobacteriaceae;Mesorhizobium;Mesorhizobium_alhagi
Cluster_285	Bacteria;Proteobacteria;Alphaproteobacteria;Rhodospirillales;unclassified;Reyranella;Reyranella_massiliensis
Cluster_286	Bacteria;Proteobacteria;Deltaproteobacteria;Desulfovibrionales;Desulfovibrionaceae;Desulfocurvus;Desulfocurvus_vexinensis
Cluster_288	Bacteria;Proteobacteria;Gammaproteobacteria;Enterobacterales;Morganellaceae;Xenorhabdus;Xenorhabdus_nematophila
Cluster_289	Bacteria;Actinobacteria;Actinobacteria;Micrococcales;Microbacteriaceae;Leucobacter;Leucobacter_sp._PH1c
Cluster_290	Bacteria;Proteobacteria;Gammaproteobacteria;Pseudomonadales;Pseudomonadaceae;Pseudomonas;Pseudomonas_sp._EGD-AK9
Cluster_291	Bacteria;Proteobacteria;Alphaproteobacteria;Rhizobiales;Phyllobacteriaceae;Aminobacter;Aminobacter_sp._Root100
Cluster_292	Bacteria;Proteobacteria;Alphaproteobacteria;Caulobacterales;Caulobacteraceae;Brevundimonas;Brevundimonas_diminuta
Cluster_293	Bacteria;Proteobacteria;Alphaproteobacteria;Caulobacterales;Caulobacteraceae;Brevundimonas;Brevundimonas_diminuta
Cluster_294	Bacteria;Proteobacteria;Alphaproteobacteria;Caulobacterales;Caulobacteraceae;unclassified;Caulobacteraceae_bacterium_OTSz_A_272
Cluster_295	Bacteria;Proteobacteria;Gammaproteobacteria;Pseudomonadales;Moraxellaceae;Perlucidibaca;Perlucidibaca_piscinae
Cluster_297	Bacteria;Proteobacteria;Betaproteobacteria;Burkholderiales;Alcaligenaceae;Achromobacter;Multi-affiliation
Cluster_298	Bacteria;Proteobacteria;Gammaproteobacteria;Xanthomonadales;Xanthomonadaceae;Stenotrophomonas;Stenotrophomonas_maltophilia
Cluster_299	Bacteria;Bacteroidetes;Flavobacteriia;Flavobacteriales;Flavobacteriaceae;Flavobacterium;Flavobacterium_frigidimaris
Cluster_300	Bacteria;Bacteroidetes;Chitinophagia;Chitinophagales;Chitinophagaceae;Sediminibacterium;Sediminibacterium_sp._C3
Cluster_302	Bacteria;Bacteroidetes;Sphingobacteriia;Sphingobacteriales;Sphingobacteriaceae;Sphingobacterium;Multi-affiliation
Cluster_303	Bacteria;Bacteroidetes;Sphingobacteriia;Sphingobacteriales;Sphingobacteriaceae;Pedobacter;Pedobacter_xixiisoli
Cluster_305	Bacteria;Bacteroidetes;unclassified;unclassified;unclassified;unclassified;Multi-affiliation
Cluster_306	Bacteria;Proteobacteria;Gammaproteobacteria;Enterobacterales;Yersiniaceae;Serratia;Serratia_liquefaciens
Cluster_307	Bacteria;Proteobacteria;Alphaproteobacteria;Caulobacterales;Caulobacteraceae;Brevundimonas;Multi-affiliation
Cluster_308	Bacteria;Proteobacteria;Alphaproteobacteria;Rhizobiales;Bradyrhizobiaceae;Afipia;Multi-affiliation
Cluster_311	Bacteria;Proteobacteria;Gammaproteobacteria;Pseudomonadales;Pseudomonadaceae;Pseudomonas;Pseudomonas_chlororaphis
Cluster_312	Bacteria;Proteobacteria;Alphaproteobacteria;Sphingomonadales;Sphingomonadaceae;Sphingopyxis;Sphingopyxis_sp._RIFCSPHIGHO2_01_FULL_65_24
Cluster_313	Bacteria;Proteobacteria;Gammaproteobacteria;Enterobacterales;Erwiniaceae;Pantoea;Pantoea_sp._3.5.1
Cluster_314	Bacteria;Proteobacteria;Betaproteobacteria;Burkholderiales;Alcaligenaceae;Achromobacter;Achromobacter_sp._2789STDY5608607
Cluster_315	Bacteria;Proteobacteria;Gammaproteobacteria;Pseudomonadales;Pseudomonadaceae;Pseudomonas;Pseudomonas_oleovorans
Cluster_316	Bacteria;Proteobacteria;Alphaproteobacteria;Sphingomonadales;Sphingomonadaceae;Sphingopyxis;Multi-affiliation
Cluster_317	Bacteria;Proteobacteria;Alphaproteobacteria;Rhizobiales;Rhizobiaceae;Sinorhizobium;Sinorhizobium_sp._RAC02
Cluster_318	Bacteria;Proteobacteria;Alphaproteobacteria;Sphingomonadales;Sphingomonadaceae;Sphingobium;Sphingobium_xenophagum
Cluster_319	Bacteria;Proteobacteria;Alphaproteobacteria;Caulobacterales;Caulobacteraceae;Phenylobacterium;Multi-affiliation
Cluster_320	Bacteria;Proteobacteria;Gammaproteobacteria;Xanthomonadales;Xanthomonadaceae;Stenotrophomonas;Stenotrophomonas_sp._KCTC_12332
Cluster_321	Bacteria;Proteobacteria;Gammaproteobacteria;Oceanospirillales;Alcanivoracaceae;Alcanivorax;Alcanivorax_pacificus
Cluster_322	Bacteria;Proteobacteria;Betaproteobacteria;Burkholderiales;Alcaligenaceae;Alcaligenes;Alcaligenes_faecalis
Cluster_323	Bacteria;Proteobacteria;Alphaproteobacteria;Rhizobiales;Rhizobiaceae;Kaistia;Kaistia_granuli
Cluster_326	Bacteria;Proteobacteria;Alphaproteobacteria;Rhizobiales;Rhizobiaceae;Rhizobium;Rhizobium_sp._RU33A
Cluster_327	Bacteria;Proteobacteria;Gammaproteobacteria;Pseudomonadales;Pseudomonadaceae;Pseudomonas;Pseudomonas_putida
Cluster_330	Bacteria;Proteobacteria;Gammaproteobacteria;Pseudomonadales;Pseudomonadaceae;Pseudomonas;Pseudomonas_sp._GM33
Cluster_332	Bacteria;Proteobacteria;Alphaproteobacteria;Rhodobacterales;Rhodobacteraceae;Rhodobacter;Rhodobacter_sp._24-YEA-8
Cluster_336	Bacteria;Proteobacteria;Alphaproteobacteria;Rhizobiales;Hyphomicrobiaceae;Devosia;Devosia_sp._LC5
Cluster_337	Bacteria;Proteobacteria;Gammaproteobacteria;Xanthomonadales;Xanthomonadaceae;Stenotrophomonas;Stenotrophomonas_maltophilia
Cluster_346	Bacteria;Proteobacteria;Alphaproteobacteria;Caulobacterales;Caulobacteraceae;Brevundimonas;Brevundimonas_diminuta
Cluster_349	Bacteria;Proteobacteria;Alphaproteobacteria;Rhizobiales;Rhizobiaceae;Shinella;Shinella_sp._DD12
Cluster_352	Bacteria;Proteobacteria;Gammaproteobacteria;Xanthomonadales;Xanthomonadaceae;Stenotrophomonas;Stenotrophomonas_maltophilia
Cluster_353	Bacteria;Proteobacteria;Betaproteobacteria;Burkholderiales;Alcaligenaceae;Achromobacter;Achromobacter_sp._DH1f
Cluster_358	Bacteria;Proteobacteria;Alphaproteobacteria;Rhizobiales;Phyllobacteriaceae;Aminobacter;Aminobacter_aminovorans
Cluster_367	Bacteria;Proteobacteria;Betaproteobacteria;Burkholderiales;Alcaligenaceae;Alcaligenes;Alcaligenes_faecalis
Cluster_377	Bacteria;Firmicutes;Bacilli;Bacillales;Paenibacillaceae;Paenibacillus;Paenibacillus_sp._Y412MC10
Cluster_380	Bacteria;Proteobacteria;Gammaproteobacteria;Pseudomonadales;Pseudomonadaceae;Pseudomonas;Multi-affiliation
Cluster_401	Bacteria;Proteobacteria;Alphaproteobacteria;Caulobacterales;Caulobacteraceae;Brevundimonas;Brevundimonas_diminuta
Cluster_425	Bacteria;Proteobacteria;Gammaproteobacteria;Pseudomonadales;Pseudomonadaceae;Pseudomonas;Pseudomonas_sp._PH1b
Cluster_433	Bacteria;Proteobacteria;Gammaproteobacteria;Xanthomonadales;Xanthomonadaceae;Stenotrophomonas;Stenotrophomonas_maltophilia
Cluster_440	Bacteria;Proteobacteria;Betaproteobacteria;Burkholderiales;Alcaligenaceae;Alcaligenes;Alcaligenes_faecalis
Cluster_480	Bacteria;Proteobacteria;Gammaproteobacteria;Pseudomonadales;Pseudomonadaceae;Pseudomonas;Multi-affiliation
Cluster_498	Bacteria;Proteobacteria;Betaproteobacteria;Burkholderiales;Alcaligenaceae;Alcaligenes;Alcaligenes_faecalis
Cluster_611	Bacteria;Proteobacteria;Gammaproteobacteria;Pseudomonadales;Pseudomonadaceae;Pseudomonas;Multi-affiliation
