observation_name	taxonomic_affiliation
Cluster_1	Bacteria;Firmicutes;Bacilli;Lactobacillales;Enterococcaceae;Enterococcus;Multi-affiliation
Cluster_2	Bacteria;Proteobacteria;Gammaproteobacteria;Betaproteobacteriales;Burkholderiaceae;Alcaligenes;Multi-affiliation
Cluster_3	Bacteria;Proteobacteria;Alphaproteobacteria;Sphingomonadales;Sphingomonadaceae;Sphingomonas;Multi-affiliation
Cluster_4	Bacteria;Proteobacteria;Alphaproteobacteria;Rhizobiales;Rhizobiaceae;Multi-affiliation;Multi-affiliation
Cluster_5	Bacteria;Proteobacteria;Gammaproteobacteria;Enterobacteriales;Enterobacteriaceae;Xenorhabdus;Multi-affiliation
Cluster_6	Bacteria;Proteobacteria;Gammaproteobacteria;Betaproteobacteriales;Burkholderiaceae;Undibacterium;unknown species
Cluster_7	Bacteria;Firmicutes;Bacilli;Bacillales;Bacillaceae;Bacillus;Multi-affiliation
Cluster_8	Bacteria;Proteobacteria;Gammaproteobacteria;Xanthomonadales;Xanthomonadaceae;Stenotrophomonas;Multi-affiliation
Cluster_9	Bacteria;Proteobacteria;Gammaproteobacteria;Pseudomonadales;Pseudomonadaceae;Pseudomonas;Multi-affiliation
Cluster_10	Bacteria;Firmicutes;Bacilli;Bacillales;Bacillaceae;Bacillus;Bacillus pseudalcaliphilus
Cluster_11	Bacteria;Firmicutes;Bacilli;Bacillales;Bacillaceae;Bacillus;Multi-affiliation
Cluster_12	Bacteria;Actinobacteria;Actinobacteria;Micrococcales;Micrococcaceae;Kocuria;Multi-affiliation
Cluster_13	Bacteria;Proteobacteria;Gammaproteobacteria;Enterobacteriales;Enterobacteriaceae;Photorhabdus;Photorhabdus luminescens
Cluster_14	Bacteria;Proteobacteria;Gammaproteobacteria;Betaproteobacteriales;Burkholderiaceae;Ralstonia;Multi-affiliation
Cluster_15	Bacteria;Proteobacteria;Gammaproteobacteria;Enterobacteriales;Enterobacteriaceae;Xenorhabdus;Multi-affiliation
Cluster_16	Bacteria;Proteobacteria;Gammaproteobacteria;Betaproteobacteriales;Burkholderiaceae;Delftia;Multi-affiliation
Cluster_17	Bacteria;Firmicutes;Bacilli;Bacillales;Bacillaceae;Bacillus;Multi-affiliation
Cluster_18	Bacteria;Proteobacteria;Gammaproteobacteria;Betaproteobacteriales;Burkholderiaceae;Multi-affiliation;Multi-affiliation
Cluster_19	Bacteria;Proteobacteria;Gammaproteobacteria;Pseudomonadales;Pseudomonadaceae;Pseudomonas;Pseudomonas sp.
Cluster_20	Bacteria;Proteobacteria;Gammaproteobacteria;Xanthomonadales;Xanthomonadaceae;Stenotrophomonas;Multi-affiliation
Cluster_21	Bacteria;Firmicutes;Bacilli;Bacillales;Bacillaceae;Bacillus;Multi-affiliation
Cluster_22	Bacteria;Proteobacteria;Gammaproteobacteria;Enterobacteriales;Enterobacteriaceae;Xenorhabdus;Xenorhabdus nematophila ATCC 19061
Cluster_23	Bacteria;Proteobacteria;Alphaproteobacteria;Rhizobiales;Rhizobiaceae;Multi-affiliation;Multi-affiliation
Cluster_24	Bacteria;Proteobacteria;Gammaproteobacteria;Enterobacteriales;Enterobacteriaceae;Serratia;Multi-affiliation
Cluster_25	Bacteria;Bacteroidetes;Bacteroidia;Flavobacteriales;Flavobacteriaceae;Flavobacterium;Flavobacterium sp.
Cluster_26	Bacteria;Proteobacteria;Alphaproteobacteria;Caulobacterales;Caulobacteraceae;Brevundimonas;unknown species
Cluster_27	Bacteria;Bacteroidetes;Bacteroidia;Flavobacteriales;Flavobacteriaceae;Flavobacterium;unknown species
Cluster_28	Bacteria;Actinobacteria;Actinobacteria;Micrococcales;Micrococcaceae;Micrococcus;Multi-affiliation
Cluster_29	Bacteria;Bacteroidetes;Bacteroidia;Sphingobacteriales;Sphingobacteriaceae;Sphingobacterium;Sphingobacterium sp.
Cluster_30	Bacteria;Firmicutes;Bacilli;Bacillales;Paenibacillaceae;Paenibacillus;Multi-affiliation
Cluster_31	Bacteria;Proteobacteria;Gammaproteobacteria;Pseudomonadales;Pseudomonadaceae;Pseudomonas;Multi-affiliation
Cluster_32	Bacteria;Proteobacteria;Gammaproteobacteria;Pseudomonadales;Moraxellaceae;Acinetobacter;Multi-affiliation
Cluster_33	Bacteria;Proteobacteria;Gammaproteobacteria;Pseudomonadales;Moraxellaceae;Acinetobacter;Multi-affiliation
Cluster_34	Bacteria;Firmicutes;Bacilli;Bacillales;Thermoactinomycetaceae;Planifilum;Multi-affiliation
Cluster_35	Bacteria;Firmicutes;Bacilli;Bacillales;Thermoactinomycetaceae;Planifilum;unknown species
Cluster_36	Bacteria;Proteobacteria;Alphaproteobacteria;Caulobacterales;Caulobacteraceae;Brevundimonas;Multi-affiliation
Cluster_37	Bacteria;Proteobacteria;Gammaproteobacteria;Enterobacteriales;Enterobacteriaceae;Serratia;Multi-affiliation
Cluster_38	Bacteria;Proteobacteria;Gammaproteobacteria;Pseudomonadales;Pseudomonadaceae;Pseudomonas;Multi-affiliation
Cluster_39	Bacteria;Firmicutes;Bacilli;Bacillales;Paenibacillaceae;Paenibacillus;Multi-affiliation
Cluster_40	Bacteria;Bacteroidetes;Bacteroidia;Sphingobacteriales;Sphingobacteriaceae;Sphingobacterium;Multi-affiliation
Cluster_41	Bacteria;Actinobacteria;Actinobacteria;Corynebacteriales;Nocardiaceae;Rhodococcus;Multi-affiliation
Cluster_42	Bacteria;Proteobacteria;Gammaproteobacteria;Betaproteobacteriales;Burkholderiaceae;Achromobacter;Multi-affiliation
Cluster_43	Bacteria;Proteobacteria;Gammaproteobacteria;Enterobacteriales;Enterobacteriaceae;Serratia;Multi-affiliation
Cluster_44	Bacteria;Firmicutes;Bacilli;Bacillales;Bacillaceae;Bacillus;Multi-affiliation
Cluster_45	Bacteria;Proteobacteria;Gammaproteobacteria;Betaproteobacteriales;Burkholderiaceae;Pelomonas;Multi-affiliation
Cluster_46	Bacteria;Proteobacteria;Alphaproteobacteria;Rhodobacterales;Rhodobacteraceae;Rubellimicrobium;unknown species
Cluster_47	Bacteria;Proteobacteria;Alphaproteobacteria;Rhizobiales;Rhizobiaceae;Multi-affiliation;Multi-affiliation
Cluster_48	Bacteria;Proteobacteria;Gammaproteobacteria;Betaproteobacteriales;Burkholderiaceae;Acidovorax;Multi-affiliation
Cluster_49	Bacteria;Proteobacteria;Gammaproteobacteria;Pseudomonadales;Pseudomonadaceae;Pseudomonas;Multi-affiliation
Cluster_50	Bacteria;Proteobacteria;Alphaproteobacteria;Caulobacterales;Caulobacteraceae;Brevundimonas;Multi-affiliation
Cluster_51	Bacteria;Proteobacteria;Gammaproteobacteria;Xanthomonadales;Xanthomonadaceae;Stenotrophomonas;Stenotrophomonas sp.
Cluster_52	Bacteria;Proteobacteria;Alphaproteobacteria;Rhizobiales;Rhizobiaceae;Allorhizobium-Neorhizobium-Pararhizobium-Rhizobium;Multi-affiliation
Cluster_53	Bacteria;Bacteroidetes;Bacteroidia;Flavobacteriales;Flavobacteriaceae;Flavobacterium;Multi-affiliation
Cluster_54	Bacteria;Proteobacteria;Alphaproteobacteria;Rhizobiales;Rhizobiaceae;Ochrobactrum;Multi-affiliation
Cluster_55	Bacteria;Proteobacteria;Gammaproteobacteria;Enterobacteriales;Enterobacteriaceae;Photorhabdus;Multi-affiliation
Cluster_56	Bacteria;Proteobacteria;Alphaproteobacteria;Sphingomonadales;Sphingomonadaceae;Sphingomonas;Multi-affiliation
Cluster_57	Bacteria;Proteobacteria;Gammaproteobacteria;Xanthomonadales;Xanthomonadaceae;Stenotrophomonas;Multi-affiliation
Cluster_58	Bacteria;Proteobacteria;Alphaproteobacteria;Rhizobiales;Xanthobacteraceae;Multi-affiliation;Multi-affiliation
Cluster_59	Bacteria;Bacteroidetes;Bacteroidia;Flavobacteriales;Flavobacteriaceae;Flavobacterium;unknown species
Cluster_60	Bacteria;Proteobacteria;Gammaproteobacteria;Betaproteobacteriales;Burkholderiaceae;Acidovorax;Multi-affiliation
Cluster_61	Bacteria;Bacteroidetes;Bacteroidia;Flavobacteriales;Flavobacteriaceae;Flavobacterium;unknown species
Cluster_62	Bacteria;Proteobacteria;Gammaproteobacteria;Pseudomonadales;Moraxellaceae;Enhydrobacter;Multi-affiliation
Cluster_63	Bacteria;Proteobacteria;Gammaproteobacteria;Pseudomonadales;Moraxellaceae;Acinetobacter;Multi-affiliation
Cluster_64	Bacteria;Proteobacteria;Gammaproteobacteria;Betaproteobacteriales;Burkholderiaceae;Multi-affiliation;Multi-affiliation
Cluster_65	Bacteria;Proteobacteria;Gammaproteobacteria;Pseudomonadales;Moraxellaceae;Acinetobacter;Multi-affiliation
Cluster_66	Bacteria;Proteobacteria;Gammaproteobacteria;Pseudomonadales;Pseudomonadaceae;Pseudomonas;Multi-affiliation
Cluster_67	Bacteria;Proteobacteria;Gammaproteobacteria;Betaproteobacteriales;Burkholderiaceae;Ralstonia;unknown species
Cluster_68	Bacteria;Proteobacteria;Gammaproteobacteria;Betaproteobacteriales;Burkholderiaceae;Undibacterium;unknown species
Cluster_69	Bacteria;Bacteroidetes;Bacteroidia;Flavobacteriales;Flavobacteriaceae;Flavobacterium;unknown species
Cluster_70	Bacteria;Bacteroidetes;Bacteroidia;Sphingobacteriales;Sphingobacteriaceae;Sphingobacterium;Multi-affiliation
Cluster_71	Bacteria;Proteobacteria;Gammaproteobacteria;Multi-affiliation;Multi-affiliation;Multi-affiliation;Multi-affiliation
Cluster_72	Bacteria;Proteobacteria;Gammaproteobacteria;Cellvibrionales;Cellvibrionaceae;Cellvibrio;metagenome
Cluster_73	Bacteria;Proteobacteria;Alphaproteobacteria;Rhizobiales;Beijerinckiaceae;Methylobacterium;Multi-affiliation
Cluster_74	Bacteria;Proteobacteria;Alphaproteobacteria;Rhodobacterales;Rhodobacteraceae;Paracoccus;Multi-affiliation
Cluster_75	Bacteria;Proteobacteria;Alphaproteobacteria;Rhizobiales;Devosiaceae;Devosia;Multi-affiliation
Cluster_77	Bacteria;Proteobacteria;Alphaproteobacteria;Sphingomonadales;Sphingomonadaceae;Sphingomonas;Multi-affiliation
Cluster_78	Bacteria;Bacteroidetes;Bacteroidia;Flavobacteriales;Flavobacteriaceae;Flavobacterium;Multi-affiliation
Cluster_79	Bacteria;Proteobacteria;Alphaproteobacteria;Rhizobiales;Beijerinckiaceae;Bosea;unknown species
Cluster_80	Bacteria;Bacteroidetes;Bacteroidia;Flavobacteriales;Flavobacteriaceae;Flavobacterium;unknown species
Cluster_81	Bacteria;Bacteroidetes;Bacteroidia;Flavobacteriales;Weeksellaceae;Chryseobacterium;unknown species
Cluster_82	Bacteria;Proteobacteria;Gammaproteobacteria;Pseudomonadales;Pseudomonadaceae;Pseudomonas;Multi-affiliation
Cluster_83	Bacteria;Proteobacteria;Alphaproteobacteria;Sphingomonadales;Sphingomonadaceae;Sphingopyxis;Multi-affiliation
Cluster_84	Bacteria;Bacteroidetes;Bacteroidia;Flavobacteriales;Flavobacteriaceae;Flavobacterium;Multi-affiliation
Cluster_85	Bacteria;Firmicutes;Bacilli;Bacillales;Bacillaceae;Bacillus;unknown species
Cluster_86	Bacteria;Firmicutes;Bacilli;Bacillales;Bacillaceae;Multi-affiliation;Multi-affiliation
Cluster_87	Bacteria;Proteobacteria;Gammaproteobacteria;Enterobacteriales;Enterobacteriaceae;Xenorhabdus;Xenorhabdus nematophila
Cluster_88	Bacteria;Proteobacteria;Gammaproteobacteria;Xanthomonadales;Xanthomonadaceae;Stenotrophomonas;Multi-affiliation
Cluster_89	Bacteria;Proteobacteria;Gammaproteobacteria;Enterobacteriales;Enterobacteriaceae;Multi-affiliation;Multi-affiliation
Cluster_90	Bacteria;Bacteroidetes;Bacteroidia;Sphingobacteriales;Sphingobacteriaceae;Pedobacter;Multi-affiliation
Cluster_91	Bacteria;Proteobacteria;Alphaproteobacteria;Sphingomonadales;Sphingomonadaceae;Sphingopyxis;Multi-affiliation
Cluster_93	Bacteria;Proteobacteria;Gammaproteobacteria;Betaproteobacteriales;Burkholderiaceae;Ralstonia;Multi-affiliation
Cluster_94	Bacteria;Proteobacteria;Gammaproteobacteria;Enterobacteriales;Enterobacteriaceae;Serratia;Serratia sp.
Cluster_95	Bacteria;Proteobacteria;Alphaproteobacteria;Sphingomonadales;Sphingomonadaceae;Sphingomonas;Multi-affiliation
Cluster_96	Bacteria;Proteobacteria;Alphaproteobacteria;Sphingomonadales;Sphingomonadaceae;Sphingomonas;Sphingomonas sp.
Cluster_97	Bacteria;Proteobacteria;Gammaproteobacteria;Betaproteobacteriales;Burkholderiaceae;Acidovorax;Multi-affiliation
Cluster_98	Bacteria;Firmicutes;Bacilli;Bacillales;Bacillaceae;Bacillus;Bacillus sp.
Cluster_99	Bacteria;Proteobacteria;Gammaproteobacteria;Betaproteobacteriales;Burkholderiaceae;Alcaligenes;Multi-affiliation
Cluster_101	Bacteria;Proteobacteria;Alphaproteobacteria;Rhizobiales;Rhizobiaceae;Multi-affiliation;Multi-affiliation
Cluster_102	Bacteria;Proteobacteria;Alphaproteobacteria;Rhizobiales;Rhizobiaceae;Multi-affiliation;Multi-affiliation
Cluster_103	Bacteria;Proteobacteria;Gammaproteobacteria;Multi-affiliation;Multi-affiliation;Multi-affiliation;Multi-affiliation
Cluster_104	Bacteria;Proteobacteria;Alphaproteobacteria;Caulobacterales;Caulobacteraceae;Phenylobacterium;Multi-affiliation
Cluster_105	Bacteria;Proteobacteria;Gammaproteobacteria;Pseudomonadales;Pseudomonadaceae;Pseudomonas;Multi-affiliation
Cluster_106	Bacteria;Proteobacteria;Gammaproteobacteria;Betaproteobacteriales;Burkholderiaceae;Advenella;Multi-affiliation
Cluster_107	Bacteria;Actinobacteria;Actinobacteria;Corynebacteriales;Corynebacteriaceae;Corynebacterium 1;Multi-affiliation
Cluster_108	Bacteria;Firmicutes;Bacilli;Bacillales;Staphylococcaceae;Staphylococcus;Multi-affiliation
Cluster_109	Bacteria;Proteobacteria;Alphaproteobacteria;Rhizobiales;Devosiaceae;Devosia;unknown species
Cluster_110	Bacteria;Firmicutes;Bacilli;Bacillales;Bacillaceae;Bacillus;Multi-affiliation
Cluster_113	Bacteria;Proteobacteria;Gammaproteobacteria;Xanthomonadales;Xanthomonadaceae;Stenotrophomonas;Multi-affiliation
Cluster_114	Bacteria;Proteobacteria;Gammaproteobacteria;Betaproteobacteriales;Burkholderiaceae;Janthinobacterium;Multi-affiliation
Cluster_115	Bacteria;Proteobacteria;Gammaproteobacteria;Pseudomonadales;Pseudomonadaceae;Pseudomonas;Multi-affiliation
Cluster_116	Bacteria;Firmicutes;Bacilli;Lactobacillales;Enterococcaceae;Multi-affiliation;Multi-affiliation
Cluster_117	Bacteria;Proteobacteria;Gammaproteobacteria;Xanthomonadales;Xanthomonadaceae;Stenotrophomonas;Multi-affiliation
Cluster_118	Bacteria;Firmicutes;Bacilli;Lactobacillales;Enterococcaceae;Enterococcus;Multi-affiliation
Cluster_119	Bacteria;Proteobacteria;Alphaproteobacteria;Rhizobiales;Rhizobiaceae;Aminobacter;Multi-affiliation
Cluster_120	Bacteria;Proteobacteria;Gammaproteobacteria;Betaproteobacteriales;Burkholderiaceae;Alcaligenes;Multi-affiliation
Cluster_121	Bacteria;Proteobacteria;Gammaproteobacteria;Betaproteobacteriales;Burkholderiaceae;Undibacterium;unknown species
Cluster_122	Bacteria;Proteobacteria;Gammaproteobacteria;Betaproteobacteriales;Burkholderiaceae;Delftia;Multi-affiliation
Cluster_125	Bacteria;Proteobacteria;Gammaproteobacteria;Xanthomonadales;Xanthomonadaceae;Luteimonas;Multi-affiliation
Cluster_126	Bacteria;Proteobacteria;Gammaproteobacteria;Pseudomonadales;Pseudomonadaceae;Pseudomonas;Multi-affiliation
Cluster_127	Bacteria;Proteobacteria;Gammaproteobacteria;Pseudomonadales;Pseudomonadaceae;Pseudomonas;Pseudomonas fulva
Cluster_128	Bacteria;Proteobacteria;Gammaproteobacteria;Betaproteobacteriales;Burkholderiaceae;Alcaligenes;Multi-affiliation
Cluster_129	Bacteria;Bacteroidetes;Bacteroidia;Chitinophagales;Chitinophagaceae;Asinibacterium;unknown species
Cluster_131	Bacteria;Proteobacteria;Gammaproteobacteria;Betaproteobacteriales;Burkholderiaceae;Alcaligenes;Multi-affiliation
Cluster_132	Bacteria;Bacteroidetes;Bacteroidia;Sphingobacteriales;Sphingobacteriaceae;Sphingobacterium;Sphingobacterium sp.
Cluster_134	Bacteria;Proteobacteria;Alphaproteobacteria;Caulobacterales;Caulobacteraceae;Brevundimonas;Multi-affiliation
Cluster_135	Bacteria;Proteobacteria;Gammaproteobacteria;Betaproteobacteriales;Burkholderiaceae;Variovorax;Multi-affiliation
Cluster_136	Bacteria;Proteobacteria;Alphaproteobacteria;Rhizobiales;Beijerinckiaceae;Bosea;Multi-affiliation
Cluster_137	Bacteria;Proteobacteria;Alphaproteobacteria;Sphingomonadales;Sphingomonadaceae;Sphingopyxis;Multi-affiliation
Cluster_138	Bacteria;Proteobacteria;Gammaproteobacteria;Enterobacteriales;Enterobacteriaceae;Xenorhabdus;Xenorhabdus nematophila
Cluster_139	Bacteria;Proteobacteria;Gammaproteobacteria;Betaproteobacteriales;Burkholderiaceae;Cupriavidus;Multi-affiliation
Cluster_140	Bacteria;Bacteroidetes;Bacteroidia;Sphingobacteriales;Sphingobacteriaceae;Sphingobacterium;Multi-affiliation
Cluster_142	Bacteria;Proteobacteria;Gammaproteobacteria;Betaproteobacteriales;Burkholderiaceae;Multi-affiliation;Multi-affiliation
Cluster_143	Bacteria;Actinobacteria;Actinobacteria;Frankiales;Geodermatophilaceae;Blastococcus;Multi-affiliation
Cluster_144	Bacteria;Proteobacteria;Gammaproteobacteria;Xanthomonadales;Xanthomonadaceae;Stenotrophomonas;Multi-affiliation
Cluster_145	Bacteria;Firmicutes;Bacilli;Bacillales;Bacillaceae;Bacillus;Multi-affiliation
Cluster_146	Bacteria;Proteobacteria;Gammaproteobacteria;Betaproteobacteriales;Burkholderiaceae;Pelomonas;Multi-affiliation
Cluster_147	Bacteria;Proteobacteria;Alphaproteobacteria;Sphingomonadales;Sphingomonadaceae;Sphingomonas;Sphingomonas sp.
Cluster_149	Bacteria;Proteobacteria;Alphaproteobacteria;Rhizobiales;Rhizobiaceae;Multi-affiliation;Multi-affiliation
Cluster_150	Bacteria;Proteobacteria;Gammaproteobacteria;Betaproteobacteriales;Burkholderiaceae;Ralstonia;unknown species
Cluster_151	Bacteria;Proteobacteria;Gammaproteobacteria;Multi-affiliation;Multi-affiliation;Multi-affiliation;Multi-affiliation
Cluster_152	Bacteria;Proteobacteria;Gammaproteobacteria;Betaproteobacteriales;Burkholderiaceae;Alcaligenes;Multi-affiliation
Cluster_153	Bacteria;Proteobacteria;Gammaproteobacteria;Pseudomonadales;Moraxellaceae;Acinetobacter;Multi-affiliation
Cluster_156	Bacteria;Proteobacteria;Gammaproteobacteria;Pseudomonadales;Pseudomonadaceae;Pseudomonas;Multi-affiliation
Cluster_158	Bacteria;Actinobacteria;Actinobacteria;Micrococcales;Microbacteriaceae;Leucobacter;Multi-affiliation
Cluster_159	Bacteria;Firmicutes;Bacilli;Lactobacillales;Enterococcaceae;Enterococcus;Multi-affiliation
Cluster_160	Bacteria;Proteobacteria;Gammaproteobacteria;Betaproteobacteriales;Burkholderiaceae;Multi-affiliation;Multi-affiliation
Cluster_161	Bacteria;Proteobacteria;Gammaproteobacteria;Enterobacteriales;Enterobacteriaceae;Xenorhabdus;Xenorhabdus romanii
Cluster_162	Bacteria;Proteobacteria;Alphaproteobacteria;Rhodobacterales;Rhodobacteraceae;Paracoccus;unknown species
Cluster_164	Bacteria;Proteobacteria;Gammaproteobacteria;Xanthomonadales;Xanthomonadaceae;Stenotrophomonas;Multi-affiliation
Cluster_165	Bacteria;Proteobacteria;Gammaproteobacteria;Betaproteobacteriales;Burkholderiaceae;Pelomonas;Multi-affiliation
Cluster_166	Bacteria;Proteobacteria;Gammaproteobacteria;Pseudomonadales;Moraxellaceae;Acinetobacter;Multi-affiliation
Cluster_167	Bacteria;Firmicutes;Bacilli;Lactobacillales;Enterococcaceae;Enterococcus;Multi-affiliation
Cluster_168	Bacteria;Proteobacteria;Gammaproteobacteria;Xanthomonadales;Rhodanobacteraceae;Tahibacter;unknown species
Cluster_169	Bacteria;Proteobacteria;Gammaproteobacteria;Betaproteobacteriales;Burkholderiaceae;Acidovorax;Multi-affiliation
Cluster_170	Bacteria;Bacteroidetes;Bacteroidia;Sphingobacteriales;Sphingobacteriaceae;Sphingobacterium;Sphingobacterium sp.
Cluster_171	Bacteria;Proteobacteria;Gammaproteobacteria;Betaproteobacteriales;Burkholderiaceae;Alcaligenes;Multi-affiliation
Cluster_172	Bacteria;Proteobacteria;Alphaproteobacteria;Multi-affiliation;Multi-affiliation;Multi-affiliation;Multi-affiliation
Cluster_173	Bacteria;Proteobacteria;Gammaproteobacteria;Xanthomonadales;Xanthomonadaceae;Stenotrophomonas;Multi-affiliation
Cluster_174	Bacteria;Proteobacteria;Gammaproteobacteria;Xanthomonadales;Xanthomonadaceae;Stenotrophomonas;Multi-affiliation
Cluster_175	Bacteria;Proteobacteria;Gammaproteobacteria;Pseudomonadales;Pseudomonadaceae;Pseudomonas;Multi-affiliation
Cluster_176	Bacteria;Proteobacteria;Gammaproteobacteria;Xanthomonadales;Xanthomonadaceae;Stenotrophomonas;Stenotrophomonas sp.
Cluster_177	Bacteria;Actinobacteria;Actinobacteria;Corynebacteriales;Nocardiaceae;Rhodococcus;Multi-affiliation
Cluster_179	Bacteria;Proteobacteria;Alphaproteobacteria;Rhizobiales;Rhizobiaceae;Mesorhizobium;Multi-affiliation
Cluster_180	Bacteria;Proteobacteria;Gammaproteobacteria;Xanthomonadales;Xanthomonadaceae;Stenotrophomonas;Multi-affiliation
Cluster_181	Bacteria;Proteobacteria;Gammaproteobacteria;Xanthomonadales;Xanthomonadaceae;Stenotrophomonas;unknown species
Cluster_183	Bacteria;Proteobacteria;Gammaproteobacteria;Pseudomonadales;Moraxellaceae;Acinetobacter;Multi-affiliation
Cluster_184	Bacteria;Proteobacteria;Alphaproteobacteria;Rhodobacterales;Rhodobacteraceae;Paracoccus;Multi-affiliation
Cluster_186	Bacteria;Proteobacteria;Gammaproteobacteria;Betaproteobacteriales;Burkholderiaceae;Variovorax;Multi-affiliation
Cluster_188	Bacteria;Bacteroidetes;Bacteroidia;Flavobacteriales;Weeksellaceae;Chryseobacterium;Multi-affiliation
Cluster_190	Bacteria;Proteobacteria;Gammaproteobacteria;Betaproteobacteriales;Burkholderiaceae;Undibacterium;unknown species
Cluster_191	Bacteria;Proteobacteria;Gammaproteobacteria;Pseudomonadales;Pseudomonadaceae;Pseudomonas;Multi-affiliation
Cluster_192	Bacteria;Proteobacteria;Gammaproteobacteria;Enterobacteriales;Enterobacteriaceae;Photorhabdus;Multi-affiliation
Cluster_193	Bacteria;Proteobacteria;Alphaproteobacteria;Caulobacterales;Caulobacteraceae;Phenylobacterium;Multi-affiliation
Cluster_194	Bacteria;Bacteroidetes;Bacteroidia;Chitinophagales;Chitinophagaceae;Terrimonas;Multi-affiliation
Cluster_196	Bacteria;Proteobacteria;Gammaproteobacteria;Betaproteobacteriales;Burkholderiaceae;Undibacterium;unknown species
Cluster_197	Bacteria;Firmicutes;Bacilli;Bacillales;Paenibacillaceae;Paenibacillus;Multi-affiliation
Cluster_199	Bacteria;Bacteroidetes;Bacteroidia;Flavobacteriales;Flavobacteriaceae;Flavobacterium;unknown species
Cluster_202	Bacteria;Bacteroidetes;Bacteroidia;Flavobacteriales;Flavobacteriaceae;Flavobacterium;unknown species
Cluster_204	Bacteria;Firmicutes;Bacilli;Bacillales;Bacillaceae;Bacillus;Bacillus carboniphilus
Cluster_205	Bacteria;Proteobacteria;Alphaproteobacteria;Acetobacterales;Acetobacteraceae;Roseomonas;Multi-affiliation
Cluster_207	Bacteria;Proteobacteria;Gammaproteobacteria;Xanthomonadales;Xanthomonadaceae;Stenotrophomonas;unknown species
Cluster_208	Bacteria;Proteobacteria;Gammaproteobacteria;Cellvibrionales;Cellvibrionaceae;Cellvibrio;Multi-affiliation
Cluster_209	Bacteria;Proteobacteria;Gammaproteobacteria;Pseudomonadales;Pseudomonadaceae;Pseudomonas;Multi-affiliation
Cluster_211	Bacteria;Proteobacteria;Gammaproteobacteria;Pseudomonadales;Pseudomonadaceae;Pseudomonas;Multi-affiliation
Cluster_212	Bacteria;Proteobacteria;Gammaproteobacteria;Betaproteobacteriales;Burkholderiaceae;Ralstonia;unknown species
Cluster_214	Bacteria;Firmicutes;Bacilli;Bacillales;Bacillaceae;Bacillus;Multi-affiliation
Cluster_216	Bacteria;Proteobacteria;Gammaproteobacteria;Betaproteobacteriales;Burkholderiaceae;Rhizobacter;Rhizobacter profundi
Cluster_217	Bacteria;Firmicutes;Bacilli;Bacillales;Bacillaceae;Bacillus;Bacillus pseudalcaliphilus
Cluster_218	Bacteria;Actinobacteria;Actinobacteria;Micrococcales;Microbacteriaceae;Microbacterium;Klebsiella pneumoniae
Cluster_219	Bacteria;Proteobacteria;Gammaproteobacteria;Enterobacteriales;Enterobacteriaceae;Serratia;Serratia entomophila
Cluster_220	Bacteria;Proteobacteria;Gammaproteobacteria;Pseudomonadales;Pseudomonadaceae;Pseudomonas;Pseudomonas fluorescens
Cluster_221	Bacteria;Proteobacteria;Alphaproteobacteria;Caulobacterales;Caulobacteraceae;Brevundimonas;unknown species
Cluster_224	Bacteria;Actinobacteria;Actinobacteria;Corynebacteriales;Corynebacteriaceae;Corynebacterium 1;unknown species
Cluster_225	Bacteria;Firmicutes;Bacilli;Bacillales;Paenibacillaceae;Paenibacillus;Multi-affiliation
Cluster_227	Bacteria;Proteobacteria;Alphaproteobacteria;Rhizobiales;Rhizobiaceae;Ochrobactrum;Multi-affiliation
Cluster_229	Bacteria;Proteobacteria;Gammaproteobacteria;Enterobacteriales;Enterobacteriaceae;Photorhabdus;Photorhabdus luminescens
Cluster_230	Bacteria;Proteobacteria;Gammaproteobacteria;Enterobacteriales;Enterobacteriaceae;Serratia;unknown species
Cluster_231	Bacteria;Proteobacteria;Gammaproteobacteria;Betaproteobacteriales;Burkholderiaceae;Ralstonia;Multi-affiliation
Cluster_233	Bacteria;Proteobacteria;Alphaproteobacteria;Acetobacterales;Acetobacteraceae;Acetobacter;Multi-affiliation
Cluster_234	Bacteria;Proteobacteria;Alphaproteobacteria;Sphingomonadales;Sphingomonadaceae;Sphingomonas;unknown species
Cluster_235	Bacteria;Firmicutes;Bacilli;Bacillales;Bacillaceae;Bacillus;Multi-affiliation
Cluster_236	Bacteria;Firmicutes;Bacilli;Lactobacillales;Streptococcaceae;Streptococcus;Multi-affiliation
Cluster_237	Bacteria;Proteobacteria;Deltaproteobacteria;Bdellovibrionales;Bacteriovoracaceae;Peredibacter;unknown species
Cluster_238	Bacteria;Proteobacteria;Gammaproteobacteria;Betaproteobacteriales;Burkholderiaceae;Ralstonia;Multi-affiliation
Cluster_240	Bacteria;Bacteroidetes;Bacteroidia;Sphingobacteriales;Sphingobacteriaceae;Sphingobacterium;Multi-affiliation
Cluster_242	Bacteria;Proteobacteria;Gammaproteobacteria;Enterobacteriales;Enterobacteriaceae;Xenorhabdus;Multi-affiliation
Cluster_243	Bacteria;Firmicutes;Bacilli;Bacillales;Bacillaceae;Oceanobacillus;Multi-affiliation
Cluster_244	Bacteria;Actinobacteria;Actinobacteria;Micrococcales;Microbacteriaceae;Marisediminicola;Microbacteriaceae bacterium 3302O2
Cluster_247	Bacteria;Proteobacteria;Gammaproteobacteria;Enterobacteriales;Enterobacteriaceae;Multi-affiliation;Multi-affiliation
Cluster_249	Bacteria;Bacteroidetes;Bacteroidia;Sphingobacteriales;Sphingobacteriaceae;Sphingobacterium;Multi-affiliation
Cluster_251	Bacteria;Firmicutes;Bacilli;Bacillales;Bacillaceae;Bacillus;Multi-affiliation
Cluster_252	Bacteria;Bacteroidetes;Bacteroidia;Chitinophagales;Chitinophagaceae;Taibaiella;unknown species
Cluster_254	Bacteria;Proteobacteria;Gammaproteobacteria;Pseudomonadales;Pseudomonadaceae;Pseudomonas;Pseudomonas sp.
Cluster_255	Bacteria;Bacteroidetes;Bacteroidia;Flavobacteriales;Flavobacteriaceae;Flavobacterium;unknown species
Cluster_258	Bacteria;Proteobacteria;Gammaproteobacteria;Betaproteobacteriales;Burkholderiaceae;Ralstonia;Multi-affiliation
Cluster_259	Bacteria;Firmicutes;Bacilli;Bacillales;Bacillaceae;Bacillus;Multi-affiliation
Cluster_260	Bacteria;Bacteroidetes;Bacteroidia;Chitinophagales;Chitinophagaceae;unknown genus;Multi-affiliation
Cluster_261	Bacteria;Proteobacteria;Alphaproteobacteria;Caulobacterales;Caulobacteraceae;Brevundimonas;Brevundimonas diminuta
Cluster_262	Bacteria;Firmicutes;Bacilli;Bacillales;Bacillaceae;Bacillus;Multi-affiliation
Cluster_266	Bacteria;Bacteroidetes;Bacteroidia;Flavobacteriales;Flavobacteriaceae;Flavobacterium;unknown species
Cluster_267	Bacteria;Proteobacteria;Alphaproteobacteria;Rhizobiales;Rhizobiaceae;Ochrobactrum;unknown species
Cluster_268	Bacteria;Proteobacteria;Gammaproteobacteria;Betaproteobacteriales;Burkholderiaceae;Methylibium;unknown species
Cluster_272	Bacteria;Proteobacteria;Gammaproteobacteria;Betaproteobacteriales;Burkholderiaceae;Alcaligenes;Multi-affiliation
Cluster_273	Bacteria;Bacteroidetes;Bacteroidia;Flavobacteriales;Flavobacteriaceae;Flavobacterium;Multi-affiliation
Cluster_274	Bacteria;Firmicutes;Bacilli;Bacillales;Bacillaceae;Bacillus;Multi-affiliation
Cluster_276	Bacteria;Proteobacteria;Alphaproteobacteria;Sphingomonadales;Sphingomonadaceae;Sphingobium;Multi-affiliation
Cluster_277	Bacteria;Proteobacteria;Gammaproteobacteria;Betaproteobacteriales;Burkholderiaceae;Alcaligenes;unknown species
Cluster_279	Bacteria;Proteobacteria;Alphaproteobacteria;Sphingomonadales;Sphingomonadaceae;Sphingomonas;unknown species
Cluster_282	Bacteria;Proteobacteria;Alphaproteobacteria;Rhizobiales;Rhizobiaceae;Aquamicrobium;Multi-affiliation
Cluster_283	Bacteria;Proteobacteria;Gammaproteobacteria;Enterobacteriales;Enterobacteriaceae;Serratia;Pectobacterium carotovorum
Cluster_284	Bacteria;Proteobacteria;Gammaproteobacteria;Salinisphaerales;Solimonadaceae;unknown genus;unknown species
Cluster_285	Bacteria;Proteobacteria;Gammaproteobacteria;Pseudomonadales;Pseudomonadaceae;Pseudomonas;Multi-affiliation
Cluster_287	Bacteria;Proteobacteria;Alphaproteobacteria;Sphingomonadales;Sphingomonadaceae;Sphingomonas;Multi-affiliation
Cluster_289	Bacteria;Bacteroidetes;Bacteroidia;Sphingobacteriales;Sphingobacteriaceae;Pedobacter;Multi-affiliation
Cluster_291	Bacteria;Bacteroidetes;Bacteroidia;Sphingobacteriales;Sphingobacteriaceae;Sphingobacterium;Multi-affiliation
Cluster_293	Bacteria;Bacteroidetes;Bacteroidia;Sphingobacteriales;Sphingobacteriaceae;Sphingobacterium;Multi-affiliation
Cluster_294	Bacteria;Firmicutes;Bacilli;Bacillales;Bacillaceae;Fictibacillus;Multi-affiliation
Cluster_297	Bacteria;Firmicutes;Bacilli;Lactobacillales;Enterococcaceae;Enterococcus;Multi-affiliation
Cluster_299	Bacteria;Proteobacteria;Gammaproteobacteria;Betaproteobacteriales;Burkholderiaceae;Alcaligenes;Multi-affiliation
Cluster_303	Bacteria;Proteobacteria;Gammaproteobacteria;Enterobacteriales;Enterobacteriaceae;Serratia;Multi-affiliation
Cluster_307	Bacteria;Bacteroidetes;Bacteroidia;Flavobacteriales;Flavobacteriaceae;Flavobacterium;unknown species
Cluster_308	Bacteria;Proteobacteria;Gammaproteobacteria;Betaproteobacteriales;Burkholderiaceae;Pseudorhodoferax;Multi-affiliation
Cluster_310	Bacteria;Proteobacteria;Gammaproteobacteria;Enterobacteriales;Enterobacteriaceae;Xenorhabdus;Multi-affiliation
Cluster_311	Bacteria;Proteobacteria;Gammaproteobacteria;Pseudomonadales;Pseudomonadaceae;Pseudomonas;Multi-affiliation
Cluster_312	Bacteria;Proteobacteria;Alphaproteobacteria;Caulobacterales;Caulobacteraceae;Caulobacter;Multi-affiliation
Cluster_315	Bacteria;Bacteroidetes;Bacteroidia;Flavobacteriales;Weeksellaceae;Cloacibacterium;unknown species
Cluster_316	Bacteria;Proteobacteria;Gammaproteobacteria;Betaproteobacteriales;Burkholderiaceae;Alcaligenes;Multi-affiliation
Cluster_319	Bacteria;Proteobacteria;Gammaproteobacteria;Pseudomonadales;Moraxellaceae;Acinetobacter;Acinetobacter tjernbergiae
Cluster_320	Bacteria;Firmicutes;Bacilli;Bacillales;Bacillaceae;Oceanobacillus;Multi-affiliation
Cluster_324	Bacteria;Proteobacteria;Alphaproteobacteria;Reyranellales;Reyranellaceae;Reyranella;Multi-affiliation
Cluster_325	Bacteria;Firmicutes;Bacilli;Lactobacillales;Enterococcaceae;Enterococcus;Multi-affiliation
Cluster_326	Bacteria;Proteobacteria;Gammaproteobacteria;Pseudomonadales;Pseudomonadaceae;Pseudomonas;Multi-affiliation
Cluster_327	Bacteria;Proteobacteria;Alphaproteobacteria;Rhizobiales;Rhizobiaceae;Multi-affiliation;Multi-affiliation
Cluster_328	Bacteria;Firmicutes;Bacilli;Bacillales;Paenibacillaceae;Paenibacillus;Multi-affiliation
Cluster_329	Bacteria;Actinobacteria;Actinobacteria;Actinomycetales;Actinomycetaceae;Actinomyces;unknown species
Cluster_332	Bacteria;Proteobacteria;Alphaproteobacteria;Rhodobacterales;Rhodobacteraceae;Rubellimicrobium;unknown species
Cluster_333	Bacteria;Firmicutes;Bacilli;Lactobacillales;Enterococcaceae;Enterococcus;Multi-affiliation
Cluster_335	Bacteria;Firmicutes;Bacilli;Bacillales;Bacillaceae;Bacillus;Multi-affiliation
Cluster_336	Bacteria;Proteobacteria;Alphaproteobacteria;Rhizobiales;Devosiaceae;Devosia;Devosia neptuniae
Cluster_337	Bacteria;Proteobacteria;Alphaproteobacteria;Reyranellales;Reyranellaceae;Reyranella;unknown species
Cluster_340	Bacteria;Proteobacteria;Gammaproteobacteria;Xanthomonadales;Xanthomonadaceae;Stenotrophomonas;Stenotrophomonas nitritireducens
Cluster_341	Bacteria;Proteobacteria;Gammaproteobacteria;Enterobacteriales;Enterobacteriaceae;Xenorhabdus;Xenorhabdus griffiniae
Cluster_342	Bacteria;Proteobacteria;Gammaproteobacteria;Betaproteobacteriales;Burkholderiaceae;Undibacterium;unknown species
Cluster_343	Bacteria;Firmicutes;Bacilli;Bacillales;Bacillaceae;Bacillus;Multi-affiliation
Cluster_344	Bacteria;Proteobacteria;Alphaproteobacteria;Rhizobiales;Rhizobiaceae;Shinella;metagenome
Cluster_345	Bacteria;Proteobacteria;Gammaproteobacteria;Enterobacteriales;Enterobacteriaceae;Serratia;unknown species
Cluster_347	Bacteria;Proteobacteria;Alphaproteobacteria;Sphingomonadales;Sphingomonadaceae;Sphingomonas;Sphingomonas sp.
Cluster_349	Bacteria;Proteobacteria;Gammaproteobacteria;Enterobacteriales;Enterobacteriaceae;Multi-affiliation;Multi-affiliation
Cluster_350	Bacteria;Proteobacteria;Gammaproteobacteria;Enterobacteriales;Enterobacteriaceae;Serratia;unknown species
Cluster_354	Bacteria;Proteobacteria;Gammaproteobacteria;Pseudomonadales;Moraxellaceae;Acinetobacter;Multi-affiliation
Cluster_356	Bacteria;Proteobacteria;Alphaproteobacteria;Rhizobiales;Rhizobiaceae;Multi-affiliation;Multi-affiliation
Cluster_360	Bacteria;Proteobacteria;Gammaproteobacteria;Enterobacteriales;Enterobacteriaceae;Xenorhabdus;Multi-affiliation
Cluster_361	Bacteria;Firmicutes;Bacilli;Bacillales;Paenibacillaceae;Paenibacillus;Multi-affiliation
Cluster_362	Bacteria;Actinobacteria;Acidimicrobiia;Microtrichales;unknown family;unknown genus;unknown species
Cluster_365	Bacteria;Bacteroidetes;Bacteroidia;Sphingobacteriales;Sphingobacteriaceae;Sphingobacterium;Multi-affiliation
Cluster_366	Bacteria;Firmicutes;Bacilli;Lactobacillales;Enterococcaceae;Enterococcus;Multi-affiliation
Cluster_368	Bacteria;Proteobacteria;Alphaproteobacteria;Rhizobiales;Rhizobiaceae;Ochrobactrum;unknown species
Cluster_369	Bacteria;Proteobacteria;Alphaproteobacteria;Sphingomonadales;Sphingomonadaceae;Sphingobium;Multi-affiliation
Cluster_373	Bacteria;Bacteroidetes;Bacteroidia;Chitinophagales;Chitinophagaceae;Flaviaesturariibacter;unknown species
Cluster_375	Bacteria;Proteobacteria;Alphaproteobacteria;Rhizobiales;Devosiaceae;Devosia;Devosia epidermidihirudinis
Cluster_376	Bacteria;Bacteroidetes;Bacteroidia;Sphingobacteriales;Sphingobacteriaceae;Nubsella;unknown species
Cluster_380	Bacteria;Firmicutes;Bacilli;Bacillales;Paenibacillaceae;Paenibacillus;Multi-affiliation
Cluster_381	Bacteria;Proteobacteria;Gammaproteobacteria;Coxiellales;Coxiellaceae;Coxiella;unknown species
Cluster_383	Bacteria;Proteobacteria;Gammaproteobacteria;Betaproteobacteriales;Burkholderiaceae;Alcaligenes;Multi-affiliation
Cluster_385	Bacteria;Proteobacteria;Gammaproteobacteria;Betaproteobacteriales;Burkholderiaceae;Cupriavidus;Multi-affiliation
Cluster_388	Bacteria;Proteobacteria;Gammaproteobacteria;Betaproteobacteriales;Burkholderiaceae;Alcaligenes;Multi-affiliation
Cluster_389	Bacteria;Proteobacteria;Alphaproteobacteria;Rhizobiales;Beijerinckiaceae;Methylobacterium;Multi-affiliation
Cluster_391	Bacteria;Proteobacteria;Alphaproteobacteria;Rhizobiales;Beijerinckiaceae;Methylobacterium;Multi-affiliation
Cluster_392	Bacteria;Proteobacteria;Gammaproteobacteria;Betaproteobacteriales;Burkholderiaceae;Alcaligenes;Multi-affiliation
Cluster_394	Bacteria;Firmicutes;Bacilli;Bacillales;Planococcaceae;Multi-affiliation;Multi-affiliation
Cluster_395	Bacteria;Proteobacteria;Gammaproteobacteria;Pseudomonadales;Moraxellaceae;Acinetobacter;Multi-affiliation
Cluster_396	Bacteria;Proteobacteria;Gammaproteobacteria;Xanthomonadales;Xanthomonadaceae;Stenotrophomonas;Stenotrophomonas sp.
Cluster_397	Bacteria;Bacteroidetes;Bacteroidia;Flavobacteriales;Flavobacteriaceae;Flavobacterium;unknown species
Cluster_398	Bacteria;Proteobacteria;Gammaproteobacteria;Betaproteobacteriales;Burkholderiaceae;Undibacterium;unknown species
Cluster_399	Bacteria;Bacteroidetes;Bacteroidia;Flavobacteriales;Flavobacteriaceae;Flavobacterium;Flavobacteriaceae bacterium Gu-R-20
Cluster_401	Bacteria;Actinobacteria;Actinobacteria;Micrococcales;Micrococcaceae;Micrococcus;Multi-affiliation
Cluster_403	Bacteria;Proteobacteria;Alphaproteobacteria;Acetobacterales;Acetobacteraceae;Gluconobacter;Multi-affiliation
Cluster_405	Bacteria;Actinobacteria;Actinobacteria;Micrococcales;Micrococcaceae;Nesterenkonia;Nesterenkonia sp.
Cluster_407	Bacteria;Proteobacteria;Gammaproteobacteria;Enterobacteriales;Enterobacteriaceae;Xenorhabdus;Xenorhabdus nematophila
Cluster_409	Bacteria;Proteobacteria;Alphaproteobacteria;Rhizobiales;Hyphomicrobiaceae;Hyphomicrobium;Multi-affiliation
Cluster_411	Bacteria;Proteobacteria;Gammaproteobacteria;Enterobacteriales;Enterobacteriaceae;Multi-affiliation;Multi-affiliation
Cluster_413	Bacteria;Proteobacteria;Deltaproteobacteria;Bdellovibrionales;Bdellovibrionaceae;Bdellovibrio;unknown species
Cluster_416	Bacteria;Bacteroidetes;Bacteroidia;Sphingobacteriales;Sphingobacteriaceae;Sphingobacterium;Multi-affiliation
Cluster_419	Bacteria;Proteobacteria;Gammaproteobacteria;Pseudomonadales;Moraxellaceae;Acinetobacter;Multi-affiliation
Cluster_423	Bacteria;Proteobacteria;Gammaproteobacteria;Betaproteobacteriales;Burkholderiaceae;Delftia;Multi-affiliation
Cluster_424	Bacteria;Firmicutes;Bacilli;Lactobacillales;Streptococcaceae;Streptococcus;Multi-affiliation
Cluster_425	Bacteria;Dependentiae;Babeliae;Babeliales;Vermiphilaceae;unknown genus;unknown species
Cluster_427	Bacteria;Proteobacteria;Gammaproteobacteria;Enterobacteriales;Enterobacteriaceae;Yersinia;Multi-affiliation
Cluster_429	Bacteria;Bacteroidetes;Bacteroidia;Flavobacteriales;Weeksellaceae;Chryseobacterium;Chryseobacterium hispanicum
Cluster_431	Bacteria;Proteobacteria;Gammaproteobacteria;Betaproteobacteriales;Burkholderiaceae;Rhizobacter;Multi-affiliation
Cluster_434	Bacteria;Firmicutes;Bacilli;Bacillales;Bacillaceae;Bacillus;Multi-affiliation
Cluster_436	Bacteria;Proteobacteria;Gammaproteobacteria;Enterobacteriales;Enterobacteriaceae;Serratia;Multi-affiliation
Cluster_441	Bacteria;Firmicutes;Bacilli;Bacillales;Bacillaceae;Bacillus;Bacillus anthracis
Cluster_442	Bacteria;Proteobacteria;Gammaproteobacteria;Salinisphaerales;Solimonadaceae;unknown genus;unknown species
Cluster_443	Bacteria;Proteobacteria;Alphaproteobacteria;Rhizobiales;Kaistiaceae;Kaistia;Multi-affiliation
Cluster_448	Bacteria;Proteobacteria;Alphaproteobacteria;Rhizobiales;Rhizobiaceae;Multi-affiliation;Multi-affiliation
Cluster_451	Bacteria;Proteobacteria;Gammaproteobacteria;Betaproteobacteriales;Burkholderiaceae;Multi-affiliation;Multi-affiliation
Cluster_453	Bacteria;Proteobacteria;Alphaproteobacteria;Rhizobiales;Rhizobiaceae;Multi-affiliation;Multi-affiliation
Cluster_454	Bacteria;Firmicutes;Bacilli;Lactobacillales;Enterococcaceae;Enterococcus;Multi-affiliation
Cluster_455	Bacteria;Proteobacteria;Gammaproteobacteria;Pseudomonadales;Pseudomonadaceae;Pseudomonas;Multi-affiliation
Cluster_456	Bacteria;Proteobacteria;Gammaproteobacteria;Betaproteobacteriales;Burkholderiaceae;Alcaligenes;Multi-affiliation
Cluster_457	Bacteria;Proteobacteria;Alphaproteobacteria;Sphingomonadales;Sphingomonadaceae;Sphingomonas;Multi-affiliation
Cluster_458	Bacteria;Bacteroidetes;Bacteroidia;Flavobacteriales;Flavobacteriaceae;Flavobacterium;Multi-affiliation
Cluster_459	Bacteria;Bacteroidetes;Bacteroidia;Flavobacteriales;Flavobacteriaceae;Flavobacterium;Multi-affiliation
Cluster_460	Bacteria;Proteobacteria;Gammaproteobacteria;Enterobacteriales;Enterobacteriaceae;Xenorhabdus;Xenorhabdus nematophila
Cluster_461	Bacteria;Proteobacteria;Gammaproteobacteria;Enterobacteriales;Enterobacteriaceae;Escherichia-Shigella;Multi-affiliation
Cluster_462	Bacteria;Proteobacteria;Alphaproteobacteria;Rhizobiales;Rhizobiaceae;Ochrobactrum;Ochrobactrum pseudogrignonense
Cluster_463	Bacteria;Proteobacteria;Alphaproteobacteria;Rhizobiales;Rhizobiaceae;Multi-affiliation;Multi-affiliation
Cluster_464	Bacteria;Proteobacteria;Alphaproteobacteria;Rhizobiales;Rhizobiaceae;Multi-affiliation;Multi-affiliation
Cluster_465	Bacteria;Bacteroidetes;Bacteroidia;Flavobacteriales;Flavobacteriaceae;Flavobacterium;unknown species
Cluster_466	Bacteria;Actinobacteria;Acidimicrobiia;Microtrichales;Ilumatobacteraceae;CL500-29 marine group;Multi-affiliation
Cluster_467	Bacteria;Proteobacteria;Alphaproteobacteria;Sphingomonadales;Sphingomonadaceae;Sandarakinorhabdus;Multi-affiliation
Cluster_468	Bacteria;Actinobacteria;Actinobacteria;Frankiales;unknown family;unknown genus;unknown species
Cluster_470	Bacteria;Actinobacteria;Actinobacteria;Propionibacteriales;Nocardioidaceae;Nocardioides;Multi-affiliation
Cluster_473	Bacteria;Proteobacteria;Gammaproteobacteria;Xanthomonadales;Xanthomonadaceae;Stenotrophomonas;Multi-affiliation
Cluster_476	Bacteria;Proteobacteria;Gammaproteobacteria;Enterobacteriales;Enterobacteriaceae;Xenorhabdus;Xenorhabdus doucetiae
Cluster_477	Bacteria;Bacteroidetes;Bacteroidia;Sphingobacteriales;env.OPS 17;unknown genus;unknown species
Cluster_479	Bacteria;Actinobacteria;Actinobacteria;Corynebacteriales;Nocardiaceae;Rhodococcus;Multi-affiliation
Cluster_481	Bacteria;Firmicutes;Bacilli;Bacillales;Sporolactobacillaceae;unknown genus;unknown species
Cluster_484	Bacteria;Proteobacteria;Alphaproteobacteria;Rhizobiales;Rhizobiaceae;Multi-affiliation;Multi-affiliation
Cluster_485	Bacteria;Proteobacteria;Gammaproteobacteria;Enterobacteriales;Enterobacteriaceae;Xenorhabdus;Multi-affiliation
Cluster_488	Bacteria;Proteobacteria;Alphaproteobacteria;Rhodobacterales;Rhodobacteraceae;Paracoccus;Multi-affiliation
Cluster_491	Bacteria;Bacteroidetes;Bacteroidia;Flavobacteriales;Crocinitomicaceae;Fluviicola;Multi-affiliation
Cluster_492	Bacteria;Proteobacteria;Gammaproteobacteria;Multi-affiliation;Multi-affiliation;Multi-affiliation;Multi-affiliation
Cluster_498	Bacteria;Proteobacteria;Alphaproteobacteria;Sphingomonadales;Sphingomonadaceae;Multi-affiliation;Multi-affiliation
Cluster_499	Bacteria;Proteobacteria;Gammaproteobacteria;Cellvibrionales;Cellvibrionaceae;Cellvibrio;metagenome
Cluster_503	Bacteria;Actinobacteria;Actinobacteria;Micrococcales;Microbacteriaceae;Leucobacter;Leucobacter salsicius M1-8
Cluster_504	Bacteria;Bacteroidetes;Bacteroidia;Chitinophagales;Chitinophagaceae;Terrimonas;unknown species
Cluster_506	Bacteria;Proteobacteria;Alphaproteobacteria;Rhizobiales;Rhizobiaceae;Ochrobactrum;Multi-affiliation
Cluster_507	Bacteria;Proteobacteria;Alphaproteobacteria;Rickettsiales;SM2D12;unknown genus;unknown species
Cluster_510	Bacteria;Actinobacteria;Actinobacteria;Micrococcales;Microbacteriaceae;Microbacterium;Multi-affiliation
Cluster_511	Bacteria;Proteobacteria;Alphaproteobacteria;Rhizobiales;Rhizobiaceae;Mesorhizobium;Multi-affiliation
Cluster_514	Bacteria;Proteobacteria;Alphaproteobacteria;Caulobacterales;Caulobacteraceae;Brevundimonas;unknown species
Cluster_515	Bacteria;Proteobacteria;Alphaproteobacteria;Rhizobiales;Rhizobiaceae;Multi-affiliation;Multi-affiliation
Cluster_516	Bacteria;Proteobacteria;Gammaproteobacteria;Enterobacteriales;Enterobacteriaceae;Xenorhabdus;Multi-affiliation
Cluster_522	Bacteria;Bacteroidetes;Bacteroidia;Flavobacteriales;Weeksellaceae;Chryseobacterium;Multi-affiliation
Cluster_523	Bacteria;Bacteroidetes;Bacteroidia;Flavobacteriales;Flavobacteriaceae;Flavobacterium;unknown species
Cluster_526	Bacteria;Proteobacteria;Alphaproteobacteria;Caulobacterales;Caulobacteraceae;Brevundimonas;unknown species
Cluster_529	Bacteria;Proteobacteria;Gammaproteobacteria;Pseudomonadales;Moraxellaceae;Acinetobacter;Multi-affiliation
Cluster_532	Bacteria;Bacteroidetes;Bacteroidia;Sphingobacteriales;Sphingobacteriaceae;Sphingobacterium;Multi-affiliation
Cluster_536	Bacteria;Proteobacteria;Gammaproteobacteria;Betaproteobacteriales;Burkholderiaceae;Ralstonia;Ralstonia sp.
Cluster_540	Bacteria;Proteobacteria;Alphaproteobacteria;Rhizobiales;Rhizobiaceae;Phyllobacterium;Multi-affiliation
Cluster_549	Bacteria;Proteobacteria;Alphaproteobacteria;Rhizobiales;Rhizobiales Incertae Sedis;Phreatobacter;unknown species
Cluster_556	Bacteria;Bacteroidetes;Bacteroidia;Flavobacteriales;Flavobacteriaceae;Flavobacterium;unknown species
Cluster_558	Bacteria;Proteobacteria;Alphaproteobacteria;Rhodobacterales;Rhodobacteraceae;Rhodobacter;unknown species
Cluster_561	Bacteria;Proteobacteria;Gammaproteobacteria;Enterobacteriales;Enterobacteriaceae;Klebsiella;Klebsiella sp.
Cluster_567	Bacteria;Proteobacteria;Gammaproteobacteria;Pseudomonadales;Pseudomonadaceae;Pseudomonas;Pseudomonas koreensis
Cluster_572	Bacteria;Proteobacteria;Gammaproteobacteria;Enterobacteriales;Enterobacteriaceae;Xenorhabdus;Xenorhabdus nematophila
Cluster_574	Bacteria;Firmicutes;Bacilli;Lactobacillales;Enterococcaceae;Enterococcus;Multi-affiliation
Cluster_578	Bacteria;Proteobacteria;Gammaproteobacteria;Enterobacteriales;Enterobacteriaceae;Multi-affiliation;Multi-affiliation
Cluster_583	Bacteria;Firmicutes;Bacilli;Bacillales;Paenibacillaceae;Paenibacillus;Multi-affiliation
Cluster_586	Bacteria;Proteobacteria;Gammaproteobacteria;Pseudomonadales;Pseudomonadaceae;Pseudomonas;Multi-affiliation
Cluster_588	Bacteria;Firmicutes;Bacilli;Lactobacillales;Lactobacillaceae;Lactobacillus;Multi-affiliation
Cluster_592	Bacteria;Firmicutes;Bacilli;Bacillales;Bacillaceae;Multi-affiliation;Multi-affiliation
Cluster_595	Bacteria;Bacteroidetes;Bacteroidia;Flavobacteriales;Flavobacteriaceae;Flavobacterium;Multi-affiliation
Cluster_604	Bacteria;Proteobacteria;Gammaproteobacteria;Xanthomonadales;Xanthomonadaceae;Luteimonas;Luteimonas sp.
Cluster_609	Bacteria;Proteobacteria;Alphaproteobacteria;Sphingomonadales;Sphingomonadaceae;Sphingomonas;Multi-affiliation
Cluster_614	Bacteria;Proteobacteria;Gammaproteobacteria;Betaproteobacteriales;Burkholderiaceae;Alcaligenes;Multi-affiliation
Cluster_617	Bacteria;Proteobacteria;Gammaproteobacteria;Pseudomonadales;Pseudomonadaceae;Pseudomonas;Multi-affiliation
Cluster_618	Bacteria;Bacteroidetes;Bacteroidia;Flavobacteriales;Flavobacteriaceae;Flavobacterium;unknown species
Cluster_620	Bacteria;Proteobacteria;Gammaproteobacteria;Enterobacteriales;Enterobacteriaceae;Xenorhabdus;Xenorhabdus nematophila
Cluster_621	Bacteria;Proteobacteria;Alphaproteobacteria;Rhizobiales;Beijerinckiaceae;Bosea;unknown species
Cluster_630	Bacteria;Proteobacteria;Alphaproteobacteria;Rhizobiales;Rhizobiaceae;Mesorhizobium;Multi-affiliation
Cluster_639	Bacteria;Bacteroidetes;Bacteroidia;Flavobacteriales;Flavobacteriaceae;Flavobacterium;Flavobacterium sp.
Cluster_643	Bacteria;Actinobacteria;Actinobacteria;Propionibacteriales;Nocardioidaceae;Nocardioides;Multi-affiliation
Cluster_646	Bacteria;Proteobacteria;Gammaproteobacteria;Betaproteobacteriales;Burkholderiaceae;Rhizobacter;Multi-affiliation
Cluster_649	Bacteria;Proteobacteria;Gammaproteobacteria;Betaproteobacteriales;Burkholderiaceae;Alcaligenes;Multi-affiliation
Cluster_653	Bacteria;Proteobacteria;Gammaproteobacteria;Betaproteobacteriales;Burkholderiaceae;Alcaligenes;Multi-affiliation
Cluster_660	Bacteria;Proteobacteria;Alphaproteobacteria;Caulobacterales;Caulobacteraceae;Brevundimonas;unknown species
Cluster_676	Bacteria;Proteobacteria;Alphaproteobacteria;Rhizobiales;Devosiaceae;Devosia;unknown species
Cluster_702	Bacteria;Proteobacteria;Gammaproteobacteria;Enterobacteriales;Enterobacteriaceae;Xenorhabdus;Xenorhabdus poinarii
Cluster_708	Bacteria;Firmicutes;Bacilli;Bacillales;Bacillaceae;Bacillus;Multi-affiliation
Cluster_712	Bacteria;Proteobacteria;Gammaproteobacteria;Betaproteobacteriales;Burkholderiaceae;Multi-affiliation;Multi-affiliation
Cluster_735	Bacteria;Proteobacteria;Gammaproteobacteria;Pseudomonadales;Moraxellaceae;Acinetobacter;Multi-affiliation
Cluster_738	Bacteria;Bacteroidetes;Bacteroidia;Flavobacteriales;Flavobacteriaceae;Flavobacterium;Multi-affiliation
Cluster_740	Bacteria;Proteobacteria;Gammaproteobacteria;Enterobacteriales;Enterobacteriaceae;Xenorhabdus;Xenorhabdus nematophila
Cluster_746	Bacteria;Proteobacteria;Alphaproteobacteria;Sphingomonadales;Sphingomonadaceae;Sphingomonas;Multi-affiliation
Cluster_764	Bacteria;Actinobacteria;Actinobacteria;Micrococcales;Microbacteriaceae;Leucobacter;Multi-affiliation
Cluster_767	Bacteria;Proteobacteria;Alphaproteobacteria;Sphingomonadales;Sphingomonadaceae;Sphingomonas;Multi-affiliation
Cluster_769	Bacteria;Proteobacteria;Gammaproteobacteria;Betaproteobacteriales;Burkholderiaceae;Pelomonas;metagenome
Cluster_782	Bacteria;Proteobacteria;Gammaproteobacteria;Xanthomonadales;Xanthomonadaceae;Stenotrophomonas;Multi-affiliation
Cluster_807	Bacteria;Proteobacteria;Gammaproteobacteria;Enterobacteriales;Enterobacteriaceae;Photorhabdus;Photorhabdus luminescens
Cluster_808	Bacteria;Proteobacteria;Gammaproteobacteria;Betaproteobacteriales;Burkholderiaceae;Delftia;Acidovorax sp.
Cluster_866	Bacteria;Proteobacteria;Gammaproteobacteria;Enterobacteriales;Enterobacteriaceae;Xenorhabdus;Multi-affiliation
Cluster_874	Bacteria;Proteobacteria;Gammaproteobacteria;Enterobacteriales;Enterobacteriaceae;Serratia;Serratia sp.
Cluster_883	Bacteria;Proteobacteria;Gammaproteobacteria;Betaproteobacteriales;Burkholderiaceae;Alcaligenes;Multi-affiliation
Cluster_951	Bacteria;Proteobacteria;Alphaproteobacteria;unknown order;unknown family;unknown genus;unknown species
Cluster_961	Bacteria;Proteobacteria;Gammaproteobacteria;Betaproteobacteriales;Burkholderiaceae;Alcaligenes;Multi-affiliation
Cluster_966	Bacteria;Proteobacteria;Gammaproteobacteria;Betaproteobacteriales;Burkholderiaceae;Variovorax;Multi-affiliation
Cluster_1063	Bacteria;Proteobacteria;Alphaproteobacteria;Rhizobiales;Rhizobiaceae;Pseudochrobactrum;Multi-affiliation
Cluster_1200	Bacteria;Firmicutes;Bacilli;Bacillales;Bacillaceae;Bacillus;Multi-affiliation
Cluster_1241	Bacteria;Proteobacteria;Gammaproteobacteria;Xanthomonadales;Xanthomonadaceae;Stenotrophomonas;unknown species
Cluster_1394	Bacteria;Proteobacteria;Alphaproteobacteria;Sphingomonadales;Sphingomonadaceae;Sphingopyxis;Multi-affiliation
